001-08-07-020
...WW...
..W..W..
.W.BY.W.
W..YB..W
.W.GP.W.
..WPGW..
...WW...
