001-10-08-003
WWWWWWWWWW
WWWWWWWWWW
WWWWWWWWWW
WWWWWWY.WW
WWWWWWW.WW
WWWWWHB.WW
WWWG.GHYBW
WWWWWWWWWW
