001-10-08-003
WWWWWWWWWW
WWWWWWWWWW
WWWB..GWWW
WWWW..WWWW
WWW....WWW
WW......WW
WG..WW..BW
WWWWWWWWWW
