001-10-08-003
WWWWWWWWWW
WWWWWWWWWW
WWWB..GWWW
WWWW..WWWW
WWW....WWW
WW..BG..WW
WG.BWWG.BW
WWWWWWWWWW
