101-11-11-030
..WWWWW..
.W.....W.
W.......W
W.Y.....W
WWWW.WWWW
W.......W
W...W.Y.W
.WWWWWWW.
