101-11-11-040
...WWWW...
..W....W..
.W......W.
W........W
WY.......W
WW.......W
W........W
W..B...BW.
.WWW.Y.W..
....WWW...
