002-10-08-004
WWWWWWWWWW
WWWWWWWWWW
WWWWW.E..W
WWWWW.Y..W
W.....PW.W
WW.W.WWW.W
WE.P.PWY.W
WWWWWWWWWW
