002-10-08-004
WWWWWWWWWW
WWWWWWWWWW
WWWWWWWWWW
WWWWW.P.YW
WE....W.WW
WW.W.WW.WW
WE.P.PWYWW
WWWWWWWWWW
