003-10-08-004
WWWWWWWWWW
WWWWWWWWWW
WWWWWWWWWW
WWWWWWWWWW
WWWWW.EWWW
WW.R.GWWWW
WWRGPEPWWW
WWWWWWWWWW
