004-10-08-004
WWWWWWWWWW
WWW.EWWWWW
WWW.WWWWWW
WWW.WWWWWW
WWW.BWWWWW
WWW.E.HWWW
WWWBPHPWWW
WWWWWWWWWW
