004-10-08-004
WWWWWWWWWW
WWW.EWWWWW
WWB.WWWWWW
WWW.WWWWWW
WWW.BWWWWW
WWW.E.HWWW
WWWBPHPWWW
WWWWWWWWWW
