005-10-08-004
WWWWWWWWWW
WWWWWWWWWW
WWWWWWWWWW
WW.RWWWWWW
WW.WWWWWWW
WW.RW.EWWW
WR.AE.AWWW
WWWWWWWWWW
