005-10-08-004
WWWWWWWWWW
WWWWWWWWWW
WWWWWWWWWW
WWWWWWWWWW
WWWWWWWWWW
WW.RW.EWWW
WR.AE.AWWW
WWWWWWWWWW
