006-10-08-005
WWWWWWWWWW
WWWWWW.AWW
WP.WWY.WEW
WW.WWW..YW
WW.W.G..EW
WW.WGW..WW
WP.WWW.AWW
WWWWWWWWWW
