006-10-08-005
WWWWWWWWWW
WWWWWW.AWW
WP...Y.WEW
WW.WWW..YW
WW.W.G..EW
WW...W..WW
WPGWWW.AWW
WWWWWWWWWW
