007-10-08-005
WWWWWWWWWW
WWW.RWWWWW
WWW.WHWWWW
WWW.WGWWWW
WWWG.A...W
WW.E.PWW.W
WE.RPA.WHW
WWWWWWWWWW
