007-10-08-005
WWWWWWWWWW
WWW.RWWWWW
WWW.WWWWWW
WWW.WGWWWW
WWWG.AWH.W
WW.E.PWW.W
WE.R.APWHW
WWWWWWWWWW
