008-10-08-015
WWWWWWWWWW
WWWWWWWWWW
WWAE.YH..W
WWHW.AWW.W
WWAW.E.Y.W
WWHE.H.W.W
WWWWW..Y.W
WWWWWWWWWW
