008-10-08-005
WWWWWWWWWW
WWWWWWWWWW
WWWE..HWWW
WWWW.EWWWW
WWWWYHWWWW
WWWWAR.WWW
WWWWWYARWW
WWWWWWWWWW
