009-10-08-005
WWWWWWWWWW
WWWWWWWWWW
WWWWWW.HWW
WWWWWW.BWW
WWWWWW.WWW
WP.WWW.WWW
WYP.YH.BWW
WWWWWWWWWW
