009-10-08-008
WWWWWWWWWW
WWWWWWWPWW
WHB..B..HW
WWH..H.BWW
WYW.W..WWW
WP..WWWWWW
WYH....BWW
WWWWWWWWWW
