009-10-08-005
WWWWWWWWWW
WWWWWWWPWW
WWWWH..HWW
WWWWW..BWW
WYWWW..WWW
WP.WW..WWW
WY..H..BWW
WWWWWWWWWW
