010-10-08-005
WWWWWWWWWW
WW.RWY.WWW
WW.W.G.WWW
WW.W.W.WWW
WW.W.G.WWW
WW.W.R.WWW
WR.WRW.YWW
WWWWWWWWWW
