010-10-08-005
WWWWWWWWWW
WW.Y.R.WWW
WW.W.G.WWW
WW.W.W.WWW
WW.W.G.WWW
WW.W.R.WWW
WR..RW.YWW
WWWWWWWWWW
