011-10-08-005
WWWWWWWWWW
W..PWWWWWW
W.WHWWWWWW
W.WR.HWWWW
W.WW.GWWWW
W.Y..RWWWW
WPW..G..YW
WWWWWWWWWW
