011-10-08-005
WWWWWWWWWW
W.PWWWWWWW
W.WHWWWWWW
W.WR.HWWWW
W.WW.GWWWW
W.WW.RWWWW
WPWW.GY.YW
WWWWWWWWWW
