012-10-08-005
WWWWWWWWWW
WWWYP..RWW
WWW.W..WWW
WWW....WWW
WWWWWP..RW
WWWWWY..WW
WWWWWWY.RW
WWWWWWWWWW
