012-10-08-005
WWWWWWWWWW
WWW.P..RWW
WWW.W..WWW
WWWY...WWW
WWWWWP..RW
WWWWWY..WW
WWWWWWY.RW
WWWWWWWWWW
