012-10-08-005
WWWWWWWWWW
WWWYP..RWW
WWWWW..WWW
WWWWW..WWW
WWWWWP..RW
WWWWWY..WW
WWWWWW..WW
WWWWWWWWWW
