013-10-08-005
WWWWWWWWWW
WWGWWWWWWW
W.R.WWWWWW
W.W..ARWWW
W.W..WWWWW
W.W..AGWWW
WRWRAWWWWW
WWWWWWWWWW
