013-10-08-005
WWWWWWWWWW
WWGWWWWWWW
W.R.WWWWWW
W.W..AWWWW
W.W..WWWWW
W.W..AGWWW
WRW.AWWWWW
WWWWWWWWWW
