014-10-08-005
WWWWWWWWWW
WWW.E.WWWW
WWWWW.H.WW
WWWWW.WWWW
WWWWWG.WWW
W....E..PW
WWHWWGP.GW
WWWWWWWWWW
