014-10-08-005
WWWWWWWWWW
WWWWE.WWWW
WWWWW.WWWW
WWWWW.WWWW
WWWWWG.WWW
WH.WWE..PW
WWHWWWP.GW
WWWWWWWWWW
