015-10-08-005
WWWWWWWWWW
WWWWWW.EWW
WWWWWW.WWW
WWWWWW.WWW
WWWWB...BW
WWWW....WW
WWR.RW.EWW
WWWWWWWWWW
