015-10-08-005
WWWWWWWWWW
WWWWWW.EWW
WWWWWW.WWW
WWWWWW.WWW
WWWWB...BW
WWWWW...WW
WWR.RW.EWW
WWWWWWWWWW
