016-10-08-005
WWWWWWWWWW
WWWWWWWWWW
WWWWWWWWWW
WWWB.WWWWW
WWWW.W.RWW
WWWYP.GE.W
WWYPBGRWEW
WWWWWWWWWW
