017-10-08-005
WWWWWWWWWW
WWWWWWWWWW
WWWWB.WWWW
WP.WW.WWWW
WW.YW.WWWW
WW.WR.WWWW
WWYPW.BRWW
WWWWWWWWWW
