017-10-08-005
WWWWWWWWWW
WWWWWWWWWW
WWWWB.WWWW
WP.WW.WWWW
WW.Y..WWWW
WW.WR.WWWW
WPY.B.BRYW
WWWWWWWWWW
