018-10-08-005
WWWWWWWWWW
WWWWRWWWWW
WWW.E.WWWW
WWW.W.WWWW
WG..E.WWWW
WW..A.WWWW
WG.AW.RWWW
WWWWWWWWWW
