018-10-08-005
WWWWWWWWWW
WWWWRWWWWW
WWW.E.WWWW
WWW.W.WWWW
WGE.E.WWWW
WWW.A.WWWW
WG.AW.RWWW
WWWWWWWWWW
