019-10-08-005
WWWWWWWWWW
WWWWGWWWWW
WWW.BPWWWW
WWW.WA.WWW
WWW.WW.WWW
WWW.BW.WWW
WWPGWWAWWW
WWWWWWWWWW
