012-08-09-45
WWWWWWWW
BG..R.GP
WWC.YCWW
P...R..G
BC..P.CB
Y...R..G
G.G.G..Y
WWWFWWWW
WWWWWWWW
