020-10-08-005
WWWWWWWWWW
WWWWWWG.WW
WWWWWWW.WW
W.RWWA..WW
W.WWWW..GW
W.W.EWA.WW
WRWEWWW.WW
WWWWWWWWWW
