020-10-08-005
WWWWWWWWWW
WWWWWWG.WW
WWWWWWW.WW
W.RWRA..WW
W.WWWW..GW
W.E.E.A.WW
WRWEWWWWWW
WWWWWWWWWW
