021-10-08-005
WWWWWWWWWW
WWWWW.RA.W
WWW.P.WY.W
WWW.W.WW.W
WWP..A.W.W
WWW..W.WYW
WWWWPR..AW
WWWWWWWWWW
