021-10-08-005
WWWWWWWWWW
WWWWW.RY.W
WWW.P.WW.W
WWW.W.WW.W
WWW..A.W.W
WWW..W.WYW
WWW.PRAWWW
WWWWWWWWWW
