022-10-08-005
WWWWWWWWWW
WWW.H.WWWW
WWW.WWWWWW
WWW.W.PWWW
WWB.BPWWWW
WWY.HAWWWW
WYH.AWWWWW
WWWWWWWWWW
