022-10-08-005
WWWWWWWWWW
WWWWWWWWWW
WWWWWWWWWW
WWWWW.PWWW
WWBWWPWWWW
WWY.HAWWWW
WYH.ABWWWW
WWWWWWWWWW
