023-10-08-005
WWWWWWWWWW
WWWWW..EWW
WWWWP.WWWW
WWWWW.WWWW
WWWEW.WWWW
WWWAYHWWWW
WWAYHP.WWW
WWWWWWWWWW
