024-10-08-005
WWWWWWWWWW
WWWWWWWWWW
WWWWWWWWWW
WWWWWWWWWW
WWWWWWWWWW
WW.PWW.PWW
WP.A..PAWW
WWWWWWWWWW
