024-10-08-005
WWWWWWWWWW
WWP.APWWWW
WWW.WWWWWW
WP..P..WWW
WW.WWW.WWW
WW.PWW.PWW
WP.A..PAWW
WWWWWWWWWW
