025-10-08-005
WWWWWWWWWW
WWWWWWWWWW
WWWWWWWWWW
WWWWWWWWWW
WWWWWWWWWW
WWWHWG.WAW
WB.BHA..GW
WWWWWWWWWW
