026-10-08-005
WWWWWWWWWW
WWWWAWWY.W
WWW.EWWW.W
WWW.WWWW.W
WWW.W.RW.W
WWW.W.WY.W
WWAERP.P.W
WWWWWWWWWW
