027-10-08-005
WWWWWWWWWW
WWW.Y..WWW
WWW.WW.WWW
WWW..W..WW
WWWWHWW.WW
WH..PY..WW
WWWWHW.PWW
WWWWWWWWWW
