027-10-08-005
WWWWWWWWWW
WW..YWWWWW
WW.WWWWWWW
WW.YWWWWWW
WWWWWWWWWW
WWWWP..WWW
WWH.HW.PWW
WWWWWWWWWW
