028-10-08-006
WWWWWWWWWW
WWWWWWWWWW
WWWWWW.HWW
WWWWWW.WWW
WWWWWY.WBW
WWWWWH..YW
WWWWWB..HW
WWWWWWWWWW
