029-10-08-006
WWWWWWWWWW
WWWWWWWH.W
WWWWWWWW.W
WWWWPWWR.W
WWWWG.WW.W
WWWWW.WW.W
WE..EGPRHW
WWWWWWWWWW
