020-11-11-105
WWWWWWWWWWW
WR...B.P.PW
WWCWWWWWCWW
WP.G..BY.GW
WWCWWWWWCWW
WG..BRY..GW
WWCWWWWWCWW
W.B.YPBP..W
WTWTWWWWWTW
WRG....G.GW
WWWWWWWWWWW
