030-10-08-006
WWWWWWWWWW
WWWWWWW.HW
WWWWWHW.WW
WWWW.YW.WW
WWWW.WW.WW
WWWWYWW.HW
WWR.R.B.BW
WWWWWWWWWW
