030-10-08-006
WWWWWWWWWW
WWWWWWW.HW
WWWWWWW.WW
WWWW.YW.WW
WWWW.WW.WW
WWWWYWW.HW
WWR.RB..BW
WWWWWWWWWW
