031-10-08-006
WWWWWWWWWW
WWWWWWWWWW
WWWWWR.WWW
WWWWWW.PWW
WWWWWW.WWW
WWWWWW.WWW
WWR..P.PRW
WWWWWWWWWW
