032-10-08-006
WWWWWWWWWW
WWWWR.WWWW
WWWWW.WWWW
WWWWW.WG.W
WWWP.AWA.W
WWWW.Y.Y.W
WWE.EPRWGW
WWWWWWWWWW
