033-10-08-006
WWWWWWWWWW
WWWWR.WWWW
WWWWW.WWWW
WWWWW.WEWW
WWWWPG.YWW
WW..RE.WWW
WWPWGY.RWW
WWWWWWWWWW
