034-10-08-006
WWWWWWWWWW
WWWWP.WWWW
WWWWW.WWWW
WWWWW.WWWW
WWWWW.YWWW
WB.WW.WWWW
WWBGYP.GWW
WWWWWWWWWW
