034-10-08-006
WWWWWWWWWW
WWWBP.WWWW
WWWWW.WWWW
WWWWW.WWWW
WWWWY.YWWW
WB.WW.WYWW
WWBG.P.GWW
WWWWWWWWWW
