035-10-08-006
WWWWWWWWWW
WWW.B..WWW
WWW.HW.WWW
WWW.EW.BWW
WWW.AW.WWW
WWH.HW.WWW
WWWAB...EW
WWWWWWWWWW
