035-10-08-006
WWWWWWWWWW
WWW.HWWWWW
WWW.WWWWWW
WWW.EW.BWW
WWW.AW.WWW
WWW.HW.WWW
WWWAB...EW
WWWWWWWWWW
