036-10-08-006
WWWWWWWWWW
WWWWWWWWWW
WWWWW.YWWW
WWWW.GW.HW
WWWW.E..WW
WWWW.W.EWW
WWWWGY.HWW
WWWWWWWWWW
