036-10-08-013
WWWWWWWWWW
WWWWWWWWWW
WWWWWEYWWW
WWW..GW.HW
WWWW.E.YWW
WWWG.W.EWW
WWWWG.YHWW
WWWWWWWWWW
