037-10-08-006
WWWWWWWWWW
WWWWWWWWWW
WWWWWW.EWW
WWWWWW.WHW
WWWWWW...W
WWWWWWE.WW
WE.E..H.EW
WWWWWWWWWW
