037-10-08-006
WWWWWWWWWW
WWWWWWWWWW
WWWWWW.EWW
WWWWWW.WHW
WWWWWW..GW
WWWWWWG.WW
WE.EWWH.EW
WWWWWWWWWW
