037-10-08-006
WWWWWWWWWW
WWWWWWWWWW
WW.E....WW
WWWW.W...W
WWWW.W..HW
WWWW.WE.WW
WE.E..H.EW
WWWWWWWWWW
