038-10-08-006
WWWWWWWWWW
WWWWWWWWWW
WWWPWWWWWW
WWWY.WWWWW
WWWR..EWWW
WEAP.RWWWW
WAEW.YEWWW
WWWWWWWWWW
