039-10-08-006
WWWWWWWWWW
WWWWWWWWWW
WWWWYH.WWW
WWWWWW.WWW
WWWWBA.BWW
WWA.AWHWWW
WWW.YB..WW
WWWWWWWWWW
