039-10-08-006
WWWWWWWWWW
WWWWWWWWWW
WWWWWH.WWW
WWWWWW.WWW
WWWWWB.WWW
WWA.AWHWWW
WWW.YBY.WW
WWWWWWWWWW
