014-09-08-12
W.WYGYW.W
W.WG.BW.W
WYWC.CWYW
WBWC.CWPW
WP.CTC.BW
WG.C.C.YW
WWWWWFWWW
....WWW..
