021-10-10-125
WRBP..PBGW
.WRB..BGW.
..WR..GW..
...W..W...
...W..W...
...W..W...
..WY...W..
.WRGY..YW.
WGPRBWRBPW
WWWWWWWWWW
