040-10-08-006
WWWWWWWWWW
WWWWW.BWWW
WWWWW.WWWW
WWWWW.WWWW
WWWWWH.WWW
WWW.AG.WWW
WPA.PBHGWW
WWWWWWWWWW
