041-10-08-006
WWWWWWWWWW
WWWWWWWWWW
WWWWWWWWWW
WWWWWE.WWW
WWWWWW.WWW
WWPH.Y.WWW
WWYP.H..EW
WWWWWWWWWW
