041-10-08-006
WWWWWWWWWW
WWWWWWWWWW
WWWWWWWWWW
WWWWWE.WWW
WWWWWW.WWW
WWPH.E.WWW
WWYPYH..EW
WWWWWWWWWW
