042-10-08-006
WWWWWWWWWW
WE..BWWWWW
WW..WWWWWW
WW..WWWWWW
WWW.WWWWWW
WWW.GWA.WW
WBGEBWW.AW
WWWWWWWWWW
