042-10-08-006
WWWWWWWWWW
WE..BWWWWW
WW..WWWWWW
WWA.WWWWWW
WWW.WWWWWW
WWWAG.A.WW
WBGEBWW.AW
WWWWWWWWWW
