043-10-08-006
WWWWWWWWWW
W.RWWWWWWW
W.WWWWW.AW
W.WR.GR.WW
W.WA.WW.WW
W.WG.AW.WW
W.RA.G..WW
WWWWWWWWWW
