043-10-08-006
WWWWWWWWWW
W.RWWWWWWW
W.WWWWW.AW
W.WWWWW.WW
W.WWWWW.WW
W.WG.WW.WW
W.RA.G..WW
WWWWWWWWWW
