044-10-08-006
WWWWWWWWWW
WWWWWWWWWW
WWWWYWWWWW
W.AWP.WWWW
W.WWW.RWWW
WR.WY.WWWW
WA..RP.YWW
WWWWWWWWWW
