044-10-08-006
WWWWWWWWWW
WWWWWWWWWW
WWWWYWWWWW
W.AWP.WWWW
W.WWW.WWWW
WR.WW.WWWW
WA..RP.YWW
WWWWWWWWWW
