045-10-08-006
WWWWWWWWWW
WWWWWWWWWW
WWWPWWWWWW
WWWG.WWWWW
W.YW.WW.PW
W.P.P...WW
WYW.G.P.WW
WWWWWWWWWW
