045-10-08-006
WWWWWWWWWW
WWWWWWWWWW
WWWPWWWWWW
WWWG.WWWWW
W.YW.WW.PW
W.P.P.W.WW
WYW.G.WPWW
WWWWWWWWWW
