046-10-08-006
WWWWWWWWWW
WWWWGWWWWW
WWWWY.WWWW
WWWWB.WWWW
WWWWW.WWWW
WWWWY.WEWW
WWWWEG.BWW
WWWWWWWWWW
