047-10-08-006
WWWWWWWWWW
WWWWWWWWWW
WWWWWWWWWW
WWWWWWWWWW
WWWW.GW.PW
WWWW.W.AYW
WWWA.GYPWW
WWWWWWWWWW
