048-10-08-006
WWWWWWWWWW
WWWWWWWWWW
WW.BWWWWWW
WB.WWWWWWW
WW.WWWWWWW
WW.YAWWEWW
WWYAG.EG.W
WWWWWWWWWW
