049-10-08-006
WWWWWWWWWW
WWWB.WWWWW
WWWW.WWWWW
WWWW.WWWWW
WG.WYA.WWW
WW.WWY.WWW
WW..GBAWWW
WWWWWWWWWW
