015-11-11-100
Y....R....B
W..Y.W.B..W
...G...P...
.P.W.B.W.Y.
BG...G...GY
RW...W...WB
B..R...P..P
WTTWTTTWTTW
W.........W
WRYGYBPGYRW
WWWWWWWWWWW
