022-06-06-030
WY.RBW
WR.PYW
WB.YRW
WG.PGW
WBCWBW
WWWWWW
