050-10-08-006
WWWWWWWWWW
WWWG.WWWWW
WWWW.PWWWW
WWWW.HE.WW
WWWW.WW.WW
WWWW.EW.WW
WWWG.H..PW
WWWWWWWWWW
