051-10-08-006
WWWWWWWWWW
WWWWWW.HWW
WWWWWW.WWW
WWWWWW.WWW
WWWWWW.WWW
WWBHA..WWW
WWWBPAPWWW
WWWWWWWWWW
