052-10-08-006
WWWWWWWWWW
WWWWWWWWWW
WWWWWWWWWW
WGWWWWWWWW
WBH.WWWWWW
WGW.BWWWWW
WWH.R...RW
WWWWWWWWWW
