052-10-08-006
WWWWWWWWWW
WWWWWWWWWW
WWW.BWWWWW
WGW.WWWWWW
WBH.WWWWWW
WGW.BWWWWW
WWH.R...RW
WWWWWWWWWW
