053-10-08-006
WWWWWWWWWW
WWWWWW.AWW
W..H...PWW
W.RWWW.WWW
W.WWWW.WWW
W.RWWYAPWW
W.HWYBPBWW
WWWWWWWWWW
