054-10-08-006
WWWWWWWWWW
WWWBWWWWWW
WW.GWWWWWW
WW.WWWW.RW
WW.WA.W.WW
WW.BW...WW
WW.GWWR.AW
WWWWWWWWWW
