055-10-08-006
WWWWWWWWWW
WWWR.WWWWW
WA.W.WWWWW
WW.W.WWWWW
WW.A.WWHWW
WW.W.WWG.W
WW.E.REHGW
WWWWWWWWWW
