056-10-08-010
WWWWWWWWWW
WWWW.YWWWW
WWWW.WWWWW
WB.W.WWWWW
WW.W.WWWHW
WB..YW.BGW
WWB.R.GRHW
WWWWWWWWWW
