056-10-08-006
WWWWWWWWWW
WWWW.YWWWW
WWWW.WWWWW
WWWW.WWWWW
WWWW.WWWHW
WB.WYW..GW
WWBWR.GRHW
WWWWWWWWWW
