057-10-08-007
WWWWWWWWWW
WWWWWP.WWW
WWWWWW.WWW
WWYB.W.WWW
WWWWBW.WWW
WWWWYW.EWW
WWWWGPEGWW
WWWWWWWWWW
