057-10-08-007
WWWWWWWWWW
WWWWGP.WWW
WWWWWW.WWW
WW.B.Y.WWW
WWWWBW.PWW
WWWWYW.EWW
WWWWGPEGWW
WWWWWWWWWW
