058-10-08-007
WWWWWWWWWW
WWWW.RAWWW
WWWW.HWWWW
WWWW.WWWWW
WWWH.WWWWW
WWWP.BWWWW
WWABPRWWWW
WWWWWWWWWW
