059-10-08-007
WWWWWWWWWW
WWW.AWP.WW
WWW.WWG.WW
WWW.WWW.WW
WWW.WWW.WW
W....BW.WW
WAWRBRG.PW
WWWWWWWWWW
