016-07-08-075
....Y..
RY..BGY
WWWCWWW
WGY..BW
WWWWCWW
WB.G.RW
WRCBYBW
WWWWWWW
