060-10-08-007
WWWWWWWWWW
WWAWWWAWWW
WWY.P.YWWW
WWW.WWWWWW
W.G.W.AWWW
WWWB..WWWW
WWGPBG.AWW
WWWWWWWWWW
