060-10-08-007
WWWWWWWWWW
WWWWWWWWWW
WWWWWWWWWW
WP..WWWWWW
WWG.W.AWWW
WWWB..WWWW
WWGPBG.AWW
