025-10-09-045
W.......GW
WP....PBYW
WG....RGBW
WP....YBYW
WWTWTWWWWW
W....W....
WY...W....
WBRB.W....
WWWWWW....
