018-11-11-085
WWWWWWWWW..
WRB...M0610RW..
WGP....BW..
WRBY...PW..
WWWWY..W...
....W..WWWW
....W...YBW
....W....GW
....W.....W
....WM0501.PGBW
....WWWWWWW
