026-10-11-045
...WWWW...
...WB.W...
WWWWG.WWWW
WR..B...RW
WYP.G...YW
WWWWB.WWWW
...WP.W...
...WY.W...
...WP.W...
...WYRW...
...WWWW...
