019-11-11-105
WWWWWWWWWWW
W.........W
W.C.WWWBC.W
W.PW.G.W..W
W.WG....W.W
W..Y......W
W.WR.BPYW.W
W..WBPYWR.W
W.G.WWW.P.W
WM0101P.G.BGWM1001W
WWWWWWWWWWW
