029-10-10-075
........WW
.......WRW
......W.YW
.....W..GW
....W..RYW
...W...BPW
..W...RYGW
.W....GRPW
W...BRBPGW
WWWWWWWWWW
