001-10-08-001
WWWWWWWWWW
WWWWWWWWWW
WWWBY..WWW
WWWWW..WWW
WWW....WWW
WWWY..BWWW
WWWWYBWWWW
WWWWWWWWWW
