002-10-08-003
WWWWWWWWWW
WWWWWWWWWW
WWW..Y..WW
WWW..B..WW
WWW.YR..WW
WWW.BP..WW
WWWBPR.RWW
WWWWWWWWWW
