003-10-08-014
WWWWWWWWWW
WWWW..WWWW
WWW....WWW
WWG.AH.GWW
WWH.WW.AWW
WWWH..AWWW
WWWW..WWWW
WWWWWWWWWW
