004-10-08-005
WWWWWWWWWW
WWWWWWWWWW
WWWWBWWWWW
WWWYR.WWWW
WWWWY.Y.WW
WWWWR.RWWW
WWWWWWBWWW
WWWWWWWWWW
