005-10-08-006
WWWWWWWWWW
WWWWY.RWWW
WWWWP.PWWW
WWWWW.GWWW
WWWW..PWWW
WWWW..GWWW
WWWWRWYWWW
WWWWWWWWWW
