006-10-08-008
WWWWWWWWWW
WWW.....WW
WWWG...AWW
WWWWH..WWW
WWWHA.BAWW
WWWGH.ABWW
WWWWGABAWW
WWWWWWWWWW
