007-10-08-004
WWWWWWWWWW
WWWWWWWWWW
WWW..YRWWW
WWW..RPWWW
WWW..PYWWW
WWW..YRWWW
WWWWWWWWWW
WWWWWWWWWW
