008-10-08-013
WWWWWWWWWW
WWWWWWWWWW
WW.....PWW
WW.....GWW
WWB..Y.BWW
WWYG.G.WWW
WWGBPWBWWW
WWWWWWWWWW
