009-10-08-005
WWWWWWWWWW
WWWWWWWWWW
WWWWW.BWWW
WWWY..RBWW
WWWWY.BRWW
WWWWW.RWWW
WWWWWWWWWW
WWWWWWWWWW
