010-10-08-025
WWWWWWWWWW
WW......WW
WR....R..W
WPGP..PA.W
WGBR..ARBW
WAGP.WBGHW
WBAGWWGHPW
WWWWWWWWWW
