011-10-08-012
WWWWWWWWWW
WW....RPWW
WW..G.WWWW
WW..W...WW
WWP.W...WW
WWWW..ARWW
WWR..GRAWW
WWWWWWWWWW
