012-10-08-019
WWWWWWWWWW
WWBYR.RYBW
WWWWW.WWWW
WWWY...YWW
WWWW...WWW
WWWW...WWW
WWWWBYRWWW
WWWWWWWWWW
