013-10-08-017
WWWWWWWWWW
WYRPR.PRYW
WWWWW.WWWW
WWWWW..WWW
WWWWW..WWW
WWWWP..WWW
WWWWW.WWWW
WWWWWWWWWW
