014-10-08-008
WWWWWWWWWW
WWWWWWWWWW
WWWWG..WWW
WWWWA..WWW
WWW.H.HGWW
WWWWAWGWWW
WWWWWWWWWW
WWWWWWWWWW
