015-10-08-004
WWWWWWWWWW
WWWWWWWWWW
WWWWWY.WWW
WWWY.R.YWW
WWWW.Y.RWW
WWWR.WRYWW
WWWWRWWWWW
WWWWWWWWWW
