016-10-08-013
WWWWWWWWWW
WWWWWWWWWW
WWBYB.RBPW
WWWBP.PYWW
WWWWR.YWWW
WWWWWPWWWW
WWWWWWWWWW
WWWWWWWWWW
