017-10-08-010
WWWWWWWWWW
WWWYRP.YWW
WWWGWGYPWW
WWWA.AGRWW
WWWW.WWWWW
WWWGAWWWWW
WWWAYWWWWW
WWWWWWWWWW
