018-10-08-008
WWWWWWWWWW
WWWWWG.WWW
WWWWWA..WW
WWWH.H.WWW
WWWA.G.WWW
WWWW.A..WW
WWWWWGWWWW
WWWWWWWWWW
