019-10-08-009
WWWWWWWWWW
WWWWB.WWWW
WWWWW.BWWW
WWYR..PWWW
WWPY..BRWW
WWRP.PRWWW
WWWW.WWWWW
WWWWWWWWWW
