032-11-11-100
WWWWWWWWWWW
WG..RWR..PW
WP....G..BW
WG...WY..PW
WY..PW.G.BW
WW.WWWWW.WW
W..P.W....W
W....W....W
W........PW
WRG..WY..BW
WWWWWWWWWWW
