020-10-08-008
WWWWWWWWWW
WWWWW.WWWW
WWWWW.YWWW
WWWW..R.WW
WWWP..G.WW
WWWWYRWGWW
WWWWWWWPWW
WWWWWWWWWW
