021-10-08-007
WWWWWWWWWW
WWWWWWWWWW
WWWW.BWWWW
WWWWWYRWWW
WWWR.BYWWW
WWWP.RP.WW
WWWWWWWWWW
WWWWWWWWWW
