022-10-08-010
WWWWWWWWWW
WWH....WWW
WWWWW..WWW
WWE...HEWW
WWWW..WWWW
WWWWE..WWW
WWWWH..WWW
WWWWWWWWWW
