023-10-08-017
WWWWWWWWWW
WWWWWWWWWW
WWWWWWWWBW
WW....Y.RW
WWP.G.A.YW
WWR.B.H.HW
WWP.A.G.GW
WWWWWWWWWW
