024-10-08-013
WWWWWWWWWW
WWWWWWWWWW
WWWP.P..WW
WWWW.G.GWW
WWWG.A.AWW
WWWP.WWWWW
WWWWWWWWWW
WWWWWWWWWW
