025-10-08-020
WWWWWWWWWW
WWWWWWWWWW
WW.BYRP.WW
WW.WWWG.WW
WWG.W.B.WW
WWP...WGWW
WWRYWGBPWW
WWWWWWWWWW
