026-10-08-017
WWWWWWWWWW
WWWBY..WWW
WWWRB..WWW
WWWYR.PWWW
WWWWW.RWWW
WWWRY.BWWW
WWWPW.YWWW
WWWWWWWWWW
