027-10-08-009
WWWWWWWWWW
WWWWWWWWWW
WWWWW.RWWW
WWWW..PRWW
WWWP.GAWWW
WWWWRAR.WW
WWWWWGPWWW
WWWWWWWWWW
