028-10-08-009
WWWWWWWWWW
WWWWWWWWWW
WWWWW.PWWW
WWWWWGWWWW
WWWA.A..WW
WWWPAWHPWW
WWPGWWWHWW
WWWWWWWWWW
