029-10-08-013
WWWWWWWWWW
WWWWB.WWWW
WWWWW..YWW
WWWY...RWW
WWWR..YBWW
WWWP.PRWWW
WWWR.WWWWW
WWWWWWWWWW
