023-11-11-075
WWWW.......
WBG.W......
.WBG.W.....
..WR..W....
...WRP.W...
....WY..WWW
.....WP.R.W
......WG..W
.......WYYW
.......W.WW
.......WWWW
