033-08-07-033
WR....RW
WPR..RGW
WBY..PYW
WPG..YGW
WRB..BRW
.WWGRWW.
...WW...
