030-10-08-014
WWWWWWWWWW
WWWWWWWWWW
WWYW..R.WW
WWRW..P.WW
WWG.A.GPWW
WWWWR.WRWW
WWWWWYWAWW
WWWWWWWWWW
