031-10-08-013
WWWWWWWWWW
WWW.B.Y.WW
WWW.YBR.WW
WWWPRYB.WW
WWWBGRYGWW
WWWWPGBYWW
WWWWWPWWWW
WWWWWWWWWW
