032-10-08-015
WWWWWWWWWW
WWW...WWWW
WB..YR..WW
WW..RW...W
WP..P...BW
WWY.W..WWW
WWPWWWRWWW
WWWWWWWWWW
