033-10-08-019
WWWWWWWWWW
WWWWBYWWWW
WWW.RPGWWW
WW..AYHGWW
WW..RPEAWW
WWW.EHAWWW
WWWWGBWWWW
WWWWWWWWWW
