034-10-08-008
WWWWWWWWWW
WWR....PWW
WWWW..WWWW
WWWRGRWWWW
WWWWPWWWWW
WWWWG.WWWW
WWW.PWWWWW
WWWWWWWWWW
