035-10-08-015
WWWWWWWWWW
WWWWBY.WWW
WWWWWB.WWW
WWWWWW.WWW
WWWPYR.WWW
WWWWWP.WWW
WWWBYRBPWW
WWWWWWWWWW
