036-10-08-010
WWWWWWWWWW
WWWYRWWWWW
WWWWPWWWWW
WWW.G.WWWW
WW..R..GWW
WWR.W..PWW
WWYRYPGWWW
WWWWWWWWWW
