037-10-08-012
WWWWWWWWWW
WW.B....WW
WW.Y..R.WW
WWYWY.WRWW
WWW.PG.WWW
WWG.RPGBWW
WWWYGRBWWW
WWWWWWWWWW
