038-10-08-011
WWWWWWWWWW
WWWWW..BYW
WWWWW..YBW
WWW...BRYW
WWPYWWWWWW
WWRBWWWWWW
WWPRWWWWWW
WWWWWWWWWW
