039-10-08-007
WWWWWWWWWW
WWWBY..WWW
WWWRP.WWWW
WWWWG.WWWW
WWWWWGWWWW
WWWW.YPWWW
WWW..RBWWW
WWWWWWWWWW
