024-10-11-165
GB....GBPR
WWW.WWWWWW
YR......YR
....W.WWWW
....B...BG
......W.WW
........YP
..........
..........
..WM0301WM0503WM0705WW
WWWWWWWWWW
