040-10-08-023
WWWWWWWWWW
WWWWW..BYW
WWWWW..RBW
WWWWW.BPYW
WWRY..WWWW
WWPBWWWWWW
WWYPWWWWWW
WWWWWWWWWW
