041-10-08-006
WWWWWWWWWW
WWW..BYWWW
WWWR.YWWWW
WWPY.R.YWW
WWYB.PYWWW
WWPY.YPWWW
WWWWYWWWWW
WWWWWWWWWW
