042-10-08-010
WWWWWWWWWW
WWW...WWWW
WWWRP..WWW
WWWWGP..WW
WWWWWR.GWW
WWWWWW.RWW
WWWWWWWWWW
WWWWWWWWWW
