043-10-08-016
WWWWWWWWWW
WWY..WWWWW
WWR.WRWWWW
WWWP.PGWWW
WWWG.YPGWW
WWWW.PYWWW
WWWWWYWWWW
WWWWWWWWWW
