044-10-08-012
WWWWWWWWWW
WWBY...RWW
WWPRP..PWW
WWWBRY.RWW
WWWWWW.WWW
WWWWWW.WWW
WWWWWWWWWW
WWWWWWWWWW
