045-10-08-010
WWWWWWWWWW
WWWBW..YWW
WWWYW.BRWW
WWWP.RGBWW
WWWW.PBGWW
WWWW.BGWWW
WWWW.YWWWW
WWWWWWWWWW
