046-10-08-007
WWWWWWWWWW
WWWB.WWWWW
WWWY....WW
WWWW...BWW
WWW..Y.YWW
WWW..BWBWW
WWW..YBYWW
WWWWWWWWWW
