047-10-08-014
WWWWWWWWWW
WWWWWWWWWW
WW.BY.RYPW
WW.RG.GPWW
WW.WW.WWWW
WWRGB.RWWW
WWWWW.BWWW
WWWWWWWWWW
