048-10-08-003
WWWWWWWWWW
WWW..B..WW
WWWY.R..WW
WWWW.W..WW
WWW..R..WW
WWWY.Y.RWW
WWWB.BWWWW
WWWWWWWWWW
