049-10-08-029
WWWWWWWWWW
WWBY.WWWWW
WWRBP..WWW
WRWWWW..WW
WG....G..W
WR.PBPBYBW
WWPWWWWWWW
WWWWWWWWWW
