050-10-08-018
WWWWWWWWWW
WWWB.YWWWW
W..Y.W..RW
WB.P..RPWW
WWWW..GWWW
WWWP.GWWWW
WWWG.YWWWW
WWWWWWWWWW
