051-10-08-025
WWWWWWWWWW
WWB....YWW
WRP.BY.GRW
WAG.WW.RPW
WWW....WWW
WWW...AWWW
WWWWAGWWWW
WWWWWWWWWW
