052-10-08-010
WWWWWWWWWW
WWWW.BWWWW
WWWW.YWWWW
W....B.RPW
WG...Y.PGW
WWWW.BWWWW
WWWW.RWWWW
WWWWWWWWWW
