053-10-08-012
WWWWWWWWWW
WWWWBYRWWW
WWWWPBYWWW
WWW.RWP.WW
WW..WWW.YW
WW..PBP.RW
WWPRWWWRBW
WWWWWWWWWW
