054-10-08-017
WWWWWWWWWW
WW..BYR.WW
WW.WWWW.YW
WW...P..GW
WWG..G..BW
WWR.BR..AW
WWBRGWYAPW
WWWWWWWWWW
