055-10-08-024
WWWWWWWWWW
WWWWWWWWWW
WBY....RPW
WPGR..AYGW
WGBP..GPAW
WAPB..WAPW
WWWWWWWWWW
WWWWWWWWWW
