056-10-08-012
WWWWWWWWWW
WW.BWY..WW
WWRPWWW.WW
WWPG..W.WW
WWRAW.W.WW
WWAGB..YWW
WWHBR.RHWW
WWWWWWWWWW
