057-10-08-016
WWWWWWWWWW
WWWWWWWWWW
W.....B..W
WY..R.P..W
WG..PRYB.W
WA..RPBH.W
WG..AEHBEW
WWWWWWWWWW
