058-10-08-005
WWWWWWWWWW
WWWB.WW..W
WWWW..A.YW
WWW.A.Y.WW
WW..GYB.WW
WWW.BWA.WW
WWWGAWYBYW
WWWWWWWWWW
