059-10-08-022
WWWWWWWWWW
B.WWWWY.YW
W.WB..R.PW
W.WW..G.GW
WB.GP.R.RA
WWWWG.W.AG
WWWWR.W.WW
