040-11-08-090
WWWWWWWWWWW
B.........Y
Y.........B
B...Y.B...Y
Y...RPG...B
B...PGP...Y
Y..RGRGR..B
WWWWWWWWWWW
