041-11-10-045
.WWWWWWWWWW
WW.GB..RY.W
WY.WWY.BW.W
.W..WWWWW.W
W...B..P..W
W.G.G..G..W
WWPRWC.W..W
.WRB......W
.WWG...WFWW
..WWWWWWWW.
