027-09-09-065
.....WWWW
..WWWW.YW
..W.BR.PW
..W.WW.WW
..W.W...W
.WWCPBR.W
WW..GPYM0604W
WR.BWWWGW
WWWWW.WWW
