042-10-08-040
WWP....PWW
W.WP..YW.W
WY.W..W.GW
WR......YW
WB..CC..BW
WR..CC..GW
WY..RB..YW
WWWWWWWWWW
