028-11-08-065
W.Y..Y..P.W
W.P..B..R.W
W.G..P..G.W
W.R..B..R.W
W.W..P..W.W
W.W..W..W.W
WFW..W..WFW
WWWWWWWWWWW
