043-11-11-070
WYGYB.YBYBW
WWWWW.WWWWW
WYPB...BGYW
WWWW...WWWW
WPR.....RPW
WWW.....WWW
WB.......YW
WW.......WW
W....B....W
W.YBYWRGY.W
WWWWWWWWWWW
