030-11-11-085
W...B....YW
W..GWP...RW
W.WW.W...WW
W...W....YW
WR.PWP...PW
WYWW.W...WW
WP........W
WR.....P..W
WBWWB..WG.W
WM0101.WW.WW..W
WWWWWWWWWWW
