001-10-08-019
WWWWWWWWWW
W........W
W.EH...G.W
W.GYB..HEW
W.WWW..WWW
W.WR....WW
W..B.Y.R.W
WWWWWWWWWW
