002-10-08-027
WWWWWWWWWW
W..WW.WW.W
W..P....RW
W..W....WW
W.PW.....W
WEY...R.HW
WBH.B.WEYW
WWWWWWWWWW
