003-10-08-028
WWWWWWWWWW
W..Y.W..WW
W..H.....W
WA.W..R..W
WGB..EP.PW
WRYG.GBPEW
WGHYHPAWHW
WWWWWWWWWW
