004-10-08-041
WWWWWWWWWW
WE.WWYPW.W
WW..WWHP.W
WR....WW.W
WW.......W
W.R.YB..BW
WWY.EH..WW
WWWWWWWWWW
