005-10-08-018
WWWWWWWWWW
WW.W.....W
W..WW.G..W
W.G..WW..W
W.Y....RHW
W.WBEH.EWW
W.YWWEWRBW
WWWWWWWWWW
