006-10-08-026
WWWWWWWWWW
WEWW.WWP.W
WG...W.A.W
WW.....WGW
W..Y..HABW
W..W..PHYW
WW.E.HWBHW
WWWWWWWWWW
