007-10-08-031
WWWWWWWWWW
W........W
W.E...B.YW
W.Y.WHY.WW
W.W..RE.WW
WY...WWG.W
WGH..ABRAW
WWWWWWWWWW
