008-10-08-010
WWWWWWWWWW
WW.W.A...W
W.P.YW.G.W
W.R.WW.H.W
W.Y.W..W.W
W.P.G....W
WWWHRA...W
WWWWWWWWWW
