009-10-08-013
WWWWWWWWWW
W....P...W
WE...W...W
WB..A.W..W
WW..W.W..W
W..W..BG.W
WWAEG.WWPW
WWWWWWWWWW
