031-11-11-085
WWWWWWW....
WBPB..W....
WRYG..W....
WWWW..W ...
...W..WWWWW
...W..YGYGW
...W..WWWWW
WWWW..W....
WB....W....
WR..PRW....
WWWWWWW....
