010-10-08-012
WWWWWWWWWW
W.....P..W
WW....W..W
WP......WW
WW.......W
WE..H....W
WH..P.PE.W
WWWWWWWWWW
