011-10-08-040
WWWWWWWWWW
W...AE...W
WA..EA..AW
WHG.WW.GHW
WBY.WW.BYW
WRP....PRW
WAEWAGWEAW
WWWWWWWWWW
