012-10-08-007
WWWWWWWWWW
W..WW...WW
W.R.W...BW
W.W.....WW
W..W.WE.WW
W...E.PW.W
W..RW.BP.W
WWWWWWWWWW
