013-10-08-018
WWWWWWWWWW
WPRW.....W
WYAPG..E.W
WWGWW.HW.W
WWA...WW.W
W.W...WW.W
W.RYH.EY.W
WWWWWWWWWW
