014-10-08-016
WWWWWWWWWW
W...WRP.GW
WH...WA.WW
WW...AW..W
W....W...W
W..R.....W
W.HP.G...W
WWWWWWWWWW
