015-10-08-019
WWWWWWWWWW
W.P.P..W.W
WEW.HW...W
WY..W....W
WW...A...W
WGE..Y...W
WWYAYWH.GW
WWWWWWWWWW
