016-10-08-014
WWWWWWWWWW
WAH......W
WWWB...WWW
W.WW...Y.W
W.W...AW.W
W....YB.PW
W...PBH.WW
WWWWWWWWWW
