017-10-08-023
WWWWWWWWWW
W.A..WW.HW
W.W...P.GW
W.W...W.WW
W......EYW
W.....HAWW
WG.REHPYRW
WWWWWWWWWW
