018-10-08-009
WWWWWWWWWW
WWW.HW.EWW
WW.EA..W.W
W..WWW..WW
W..WW...WW
W..B....WW
WB.WWH.A.W
WWWWWWWWWW
