019-10-08-024
WWWWWWWWWW
WW.BEHWW.W
WBRWYW...W
WRA.G....W
WWW.W.R..W
WRY.RAG.PW
WWBEBHRPBW
WWWWWWWWWW
