020-10-08-041
WWWWWWWWWW
WB..Y.EW.W
WW.GWRB..W
W..W.EW..W
W....W..RW
WY.P..BGHW
WH.E..EYPW
WWWWWWWWWW
