021-10-08-044
WWWWWWWWWW
W..AH.H.PW
WA.WG.W.HW
WYGPH...AW
WABEB.HYWW
WYEHW.PGRW
WGHGB.RPBW
WWWWWWWWWW
