022-10-08-032
WWWWWWWWWW
W..BW..GPW
W.HW...EWW
W.W....W.W
WBH...AYRW
WRE.EHRAGW
WPWHWRYWWW
WWWWWWWWWW
