023-10-08-033
WWWWWWWWWW
WE.WE.R.YW
WA.WY.W.BW
WW..E...PW
W...WG..WW
WGR.EABPWW
WYB.GEYBAW
WWWWWWWWWW
