024-10-08-022
WWWWWWWWWW
WW.GBW..PW
W..HY...HW
W.YWW...YW
W.GW..EHGW
W.H...GBWW
WYEWYHYP.W
WWWWWWWWWW
