025-10-08-047
WWWWWWWWWW
WW.RYHWWGW
W..WWWW.HW
WRB.....RW
WWWH.A..EW
WE.Y.Y..WW
WWBPAGHPEW
WWWWWWWWWW
