026-10-08-044
WWWWWWWWWW
WY..AW...W
WW.AG..Y.W
W..EW.PW.W
WW.G..WWBW
W..W.W.GPW
WEP.ABHPHW
WWWWWWWWWW
