027-10-08-017
WWWWWWWWWW
W..B....WW
W..W.....W
WY.W.....W
WWG..B...W
W.AE.W..AW
WYWR.ER.GW
WWWWWWWWWW
