028-10-08-032
WWWWWWWWWW
WG...H.HBW
WPE..W.RAW
WYA..R.GPW
WWG.AYRHWW
WWHPRAHAHW
WEPGWHBPAW
WWWWWWWWWW
