029-10-08-023
WWWWWWWWWW
W.G.WWW..W
W.W....B.W
W.W....WGW
W.H....RHW
WYA..R.AWW
WWWB.AGY.W
WWWWWWWWWW
