050-10-10-015
.YGBYRP...
.BCCCCC...
..GBYRP...
..CCCCC...
.BGBYRP...
.YCCCCC...
.BGBYRP...
.YRGBYRP..
.BYRGBYRP.
