030-10-08-036
WWWWWWWWWW
W..BPG.RWW
W..RWREWWW
WEPWWBYW.W
WYRB.WB..W
WGWH.AE.HW
WYEGRBYABW
WWWWWWWWWW
