031-10-08-014
WWWWWWWWWW
W...R.HW.W
W...W.W.HW
W.......YW
WE...R..WW
WA...P.A.W
WW.PEW.Y.W
WWWWWWWWWW
