032-10-08-025
WWWWWWWWWW
W..W.R.G.W
W....P.R.W
W.E.WYRWWW
W.P..BW.GW
W.RH.WW.YW
WPBEHRG.WW
WWWWWWWWWW
