033-10-08-024
WWWWWWWWWW
WH..WE...W
WR...W...W
WW......GW
WW.BA...YW
W.GHP...WW
WERWA.YBPW
WWWWWWWWWW
