034-10-08-040
WWWWWWWWWW
W.RP.HWERW
W.WR.W.REW
W..E.P.ARW
WB.R.H.REW
WPYBAY.GYW
WHWGYREHPW
WWWWWWWWWW
