035-10-08-013
WWWWWWWWWW
W...HWR..W
W...R.WA.W
W...E..P.W
W...W..W.W
W....ABE.W
W..HEPWBEW
WWWWWWWWWW
