036-10-08-035
WWWWWWWWWW
W.Y..A...W
W.G.GW...W
W.E.WW..BW
WRWGY...HW
WBRHRP.RAW
WRAEPB.ERW
WWWWWWWWWW
