037-10-08-014
WWWWWWWWWW
WWW..W...W
W........W
W......GWW
W..WY..W.W
W...H....W
WPGHPEYEWW
WWWWWWWWWW
