038-10-08-018
WWWWWWWWWW
W..A.W.WWW
W..P....WW
W..W....WW
W.....GW.W
W.REP.WE.W
WEAGBEBR.W
WWWWWWWWWW
