039-10-08-032
WWWWWWWWWW
WR.B.R.R.W
WW.W.WAW.W
WWB...B..W
WAE...YR.W
WBP.PYWPGW
WWBPGERBRW
WWWWWWWWWW
