034-10-08-040
WWWWWWWWWW
W.Y...Y.GW
WTWWWWW.WW
W.WWWWW.WW
W.B.Y...RW
WGPBGP..WW
WRWYWW.G.W
WWWWWWWWWW
