040-10-08-026
WWWWWWWWWW
WE.B.W.R.W
WY.WHA.W.W
WB..AR.W.W
WP.YPWP..W
WAGEHBG..W
WRYPBYR.RW
WWWWWWWWWW
