041-10-08-012
WWWWWWWWWW
W...Y.Y..W
W.Y.W.W..W
W.W......W
W...P....W
W..AR....W
W..HARH.PW
WWWWWWWWWW
