042-10-08-025
WWWWWWWWWW
W.....Y.BW
WR..A.W.PW
WA..W.GYWW
WW..E.HW.W
WEP.W.W..W
WGR....HBW
WWWWWWWWWW
