043-10-08-012
WWWWWWWWWW
W..B.....W
W..W..R.WW
WP....E..W
WW.E.PW..W
W..Y.W...W
W.YBGR..GW
WWWWWWWWWW
