044-10-08-015
WWWWWWWWWW
W.W...WR.W
W..P...W.W
W..YE....W
WW.WH....W
WRP.Y...BW
WWWAEAHBWW
WWWWWWWWWW
