045-10-08-029
WWWWWWWWWW
W..AW..WWW
W..W....RW
W......WAW
W.....EYHW
W..B..WWWW
W.YR.HEABW
WWWWWWWWWW
