046-10-08-012
WWWWWWWWWW
WR.W..W..W
WW.W.....W
W........W
W.PBAR...W
W.RPHAE.EW
WAHBAYR.YW
WWWWWWWWWW
