047-10-08-018
WWWWWWWWWW
WW..H.W..W
WR..B..G.W
WA..W..Y.W
WPH..P.RBW
WWP..R.WWW
WYR.AG.RPW
WWWWWWWWWW
