048-10-08-036
WWWWWWWWWW
W..W.W.YWW
W....H.PHW
W....B.APW
W.E.BYEBWW
WEWPYARARW
WBERGRGHPW
WWWWWWWWWW
