049-10-08-017
WWWWWWWWWW
W.......WW
W.P....EBW
W.W....WWW
WW.......W
W...Y.GYEW
W.R.R.PBGW
WWWWWWWWWW
