035-11-11-100
WWWWWWWWWWW
W......W..W
W......W..W
WB.....W..W
WYB....W..W
WBRY...W..W
WRYRB..W..W
WGPGPR.W..W
WRGRBY....W
WWWWWWWWM0101.W
.......WWWW
