050-10-08-024
WWWWWWWWWW
WG..H.W..W
WYRHG.E.BW
WPAPA.A.PW
WEYHR.E.YW
WPWBY.Y.EW
WWRAH.WEYW
WWWWWWWWWW
