051-10-08-022
WWWWWWWWWW
W.A..W..WW
W.W..Y...W
W.W..W..EW
W...P.W.YW
W.HERG..GW
WYPHPRAYWW
WWWWWWWWWW
