052-10-08-031
WWWWWWWWWW
W.E.R.WW.W
W.H.P..R.W
W.EGW..A.W
WYWPY..H.W
WB.BHB.E.W
WR.HBAPGHW
WWWWWWWWWW
