053-10-08-024
WWWWWWWWWW
W..W....GW
WAB.....WW
WGH..P...W
WWW.WG..HW
W....W.RPW
WBW..GRPAW
WWWWWWWWWW
