054-10-08-007
WWWWWWWWWW
WW.......W
W.Y.W....W
W.H..A...W
W.W..W...W
WH...B...W
WYA..G.GBW
WWWWWWWWWW
