055-10-08-024
WWWWWWWWWW
W..WW..BWW
W...HR.E.W
W..AWW.PWW
WW.EAG.W.W
WAHBEP.R.W
WPAWGH.P.W
WWWWWWWWWW
