056-10-08-028
WWWWWWWWWW
W..G.BY.EW
WE.P.WW.WW
WB.B..W.BW
WEGYW...WW
WBHWPE..PW
WREHEBRPEW
WWWWWWWWWW
