057-10-08-037
WWWWWWWWWW
WH....A.WW
WA....Y..W
WW.WREW..W
W..HYW.BRW
WHEPBP.GPW
WWGAYH.YHW
WWWWWWWWWW
