058-10-08-021
WWWWWWWWWW
WW....W.EW
W.....H.PW
W.....B.WW
WR....W..W
WE.E.RGPHW
WWHA.BAGWW
WWWWWWWWWW
