059-10-08-014
WWWWWWWWWW
W.W..BE..W
W...BWW..W
WW..WA...W
W....YR..W
WY...WW..W
WARE.WE.EW
WWWWWWWWWW
