036-11-09-050
WWWWWWWWWWW
WPRBYPBRYBW
WYGWWWWWPRW
WBYBY.GRBGW
WYRYR.BGYRW
WRGBY.RPRPW
WWWWW.WWWWW
W.........W
WWWWWWWWWWW
