032-10-08-015
WWWWWWWWWW
WWW.G.WWWW
WB..YR..WW
WW..RW..GW
WPG.P..GBW
WWYGW..WWW
WWPWWWRWWW
WWWWWWWWWW
