037-11-11-045
.....W.....
....WPW....
...WBRYW...
..WR.B.RW..
.WP..Y..PW.
WB.......RW
.WG.....GW.
..WG...GW..
...WY.RW...
....WM0101W....
.....W.....
