038-11-11-095
WWW.....WWW
W.W.R.R.W.W
W..WWCWW..W
WP.W...W.PW
WG.B...Y.RW
WY.WC.CW.PW
WG.W...W.BW
WB.W...W.GW
WY.......YW
WM0101W..M0101..WM0101W
WWWWWWWWWWW
