039-07-07-055
WWWWWWW
W.P.P.W
W.R.R.P
W.YRY.W
G.GBGBW
WM0103BRYM0501W
WWWWWWW
