004-09-05-055
WYW...WGW
WBW...WPW
WP.....YW
WGM0202.W.M0602BW
WWWWWWWWW
