001-10-08-021
WWWWWWWWWW
WWWW..HWWW
WWWW.WWAWW
W.GW.W.GWW
W.WW.W.WWW
W.WW...WWW
W...G..AHW
WWWWWWWWWW
