002-10-08-018
WWWWWWWWWW
W.BWWB.WAW
W.WWWA..YW
W.WWWW..WW
W.A.WW..WW
W.W.....WW
W....YW.WW
WWWWWWWWWW
