003-10-08-017
WWWWWWWWWW
WWWWWWWWWW
WWWWWWWWWW
WWWWWW.BWW
WB.R...WWW
WWRWW..WWW
W.E.R..EWW
WWWWWWWWWW
