004-10-08-017
WWWWWWWWWW
WWWWWWWWWW
WWWWWWWWWW
WG.R.WWWWW
WH.W.WWWWW
WW.W.RWWWW
W....G.GHW
WWWWWWWWWW
