005-10-08-015
WWWWWWWWWW
WWWWW.YWWW
WA....WWWW
WWWW..WWWW
WWWW..WWWW
WGWW..WGWW
WY..A..AWW
WWWWWWWWWW
