006-10-08-014
WWWWWWWWWW
WR.WWEWWWW
WE.W.B.WWW
WW.W.W.WWW
WW.W.W.WWW
WW....EWWW
WW.WB.RWWW
WWWWWWWWWW
