008-10-08-026
WWWWWWWWWW
WWWWWWWWWW
WWWWWWWWWW
WWWWWWWWWW
WWWWRY.WWW
WG.WWW..WW
WBYGR..B.W
WWWWWWWWWW
