009-10-08-022
WWWWWWWWWW
WWWWWWWWGW
WWWWWWW.YW
WWE.WWW.WW
WWW.WW..WW
WW..A..EWW
WAGWY..WWW
WWWWWWWWWW
