010-10-08-020
WWWWWWWWWW
WB.WWWWWWW
WW.WWWWWWW
WP.WWWWWWW
WW.WWWWWWW
WW..WW..YW
WGY..PG.BW
WWWWWWWWWW
