011-10-08-019
WWWWWWWWWW
WWWWWWWWWW
WY.WWW.AWW
WW.WWW.WWW
WW.WWW.WWW
WW.PW..WWW
WE.A.E.YPW
WWWWWWWWWW
