012-10-08-019
WWWWWWWWWW
WWWWWWWWWW
WWWWWWWWWW
WWWWWWWWWW
WBG..WW.AW
WAWW.WW.WW
WY...G.BYW
WWWWWWWWWW
