013-10-08-019
WWWWWWWWWW
WWWWWWWWWW
WWWWWWWWWW
WWGWWWWWWW
WWH.WWWWWW
WWW.W.H.YW
WEY...E.GW
WWWWWWWWWW
