014-10-08-018
WWWWWWWWWW
WWWWWWWWWW
WWWWWWWWWW
WWWWWWWHWW
WWWWWW.G.W
WWE....WGW
WAH.A...EW
WWWWWWWWWW
