015-10-08-017
WWWWWWWWWW
WBWWWWWWWW
WAY..A.WWW
WWWWWBA.WW
WWWWWWW.WW
WWWWWWW.YW
WWWWWWW.AW
WWWWWWWWWW
