016-10-08-017
WWWWWWWWWW
WWWRWWWWWW
WWWG..GWWW
WWWWW.WWWW
WWWWW.WWWW
WWWWW...AW
WBA....BRW
WWWWWWWWWW
