017-10-08-017
WWWWWWWWWW
WWW.RWWWWW
WWW.WWWH.W
WWH.WWWW.W
WPR.WWB..W
WWW..WW..W
WWB...P..W
WWWWWWWWWW
