018-10-08-016
WWWWWWWWWW
WWWA.WWWHW
WWWW.WW.AW
WWWW.WW.WW
WWWW.WW.WW
WWWW.WW.WW
WBHG.G..BW
WWWWWWWWWW
