019-10-08-016
WWWWWWWWWW
WWWWWWWWWW
WWWWWWWWWW
WWWWWWWWWW
WY.WWWAWWW
WA.WWWY.GW
WG.E..E.WW
WWWWWWWWWW
