020-10-08-016
WWWWWWWWWW
WWWWWWWWWW
WWWWWWW.AW
WWWWWWW.WW
WWG..HW.WW
WWA..WW.WW
WHB...G.BW
WWWWWWWWWW
