021-10-08-026
WWWWWWWWWW
WWWWWWWWWW
WWWWA.WWWW
WY.YW.WWWW
WW.B....RW
W..WW.W.YW
WRWW..ABWW
WWWWWWWWWW
