022-10-08-022
WWWWWWWWWW
WWWWWWWWWW
WWWWWWWWWW
WWWWWWWWWW
WBY.WWWEWW
WWW....BAW
WA....EYBW
WWWWWWWWWW
