023-10-08-021
WWWWWWWWWW
WWWWWWWWWW
WR.WWWWWWW
WP.WWWWWWW
WW.WWWWWWW
WW...W.RAW
WPAPB..BWW
WWWWWWWWWW
