024-10-08-020
WWWWWWWWWW
WWHWWWWWWW
W.Y.WWWWWW
W.W.W.Y.GW
WB....W.WW
WH..WWW.WW
WW..BG..BW
WWWWWWWWWW
