025-10-08-020
WWWWWWWWWW
WWWW.YWWWW
WWWW.WWWWW
WWWW.WWWWW
WWWW.WWYWW
WWA....AEW
WWG...EGYW
WWWWWWWWWW
