026-10-08-020
WWWWWWWWWW
WWWWWWWWWW
WWWWWWWWWW
WA.WWWW.PW
WY.RWWW.RW
WW.Y.WW.YW
WW.P.A..WW
WWWWWWWWWW
