027-10-08-020
WWWWWWWWWW
WWWWWWWWWW
WWWWWWW.GW
WWWWWWW.AW
WWAWWW..WW
WWH.WW.WWW
WWAG.P.PHW
WWWWWWWWWW
