028-10-08-019
WWWWWWWWWW
WWWWG.WWWW
W.BWH.WWWW
W.WWW.WWWW
W.WWH.WWWW
W..EW.WWWW
W..H.G.BEW
WWWWWWWWWW
