029-10-08-018
WWWWWWWWWW
WWWW.AW.GW
WY.G.WW.WW
WR.WWWW.WW
WW.WWWW.WW
WY.WWWW.WW
WG..R...AW
WWWWWWWWWW
