032-10-08-018
WWWWWWWWWW
WG.W.BGWWW
WW...WWE.W
WW..WWWW.W
WW..WWWW.W
WW..WWW..W
W.B.AGE.AW
WWWWWWWWWW
