033-10-08-018
WWWWWWWWWW
WWWWE.WWWW
WWWWW.WWWW
WWWWW.WGWW
WYWW...YWW
WE...W.HWW
WGH..E.WWW
WWWWWWWWWW
