035-10-08-027
WWWWWWWWWW
WWWWB.WWWW
WWWWW.WWWW
WWWWW.WWWW
WR.Y..WWWW
WW.ARE.EAW
W..YWW.WBW
WWWWWWWWWW
