038-10-08-026
WWWWWWWWWW
WWWWWWWWYW
WE.WWG..GW
WW.WWW..WW
WW.WWW.WWW
WB......HW
WH..YEW.BW
WWWWWWWWWW
