044-11-09-065
WYR..PR.GRW
WGYP.WW.RGW
WWWB.BPWWWW
W.YG.WWG.RW.
WWWW.WYR.WW
W.B.P.WWG.W
W.P.G.Y.B.W
WFW.WFW.WFW
WWWWWWWWWWW
