042-10-08-024
WWWWWWWWWW
WWWWWWWWWW
WWW.GWWWWW
WWWGWYH.WW
WWWR.WW.WW
WWWW..WB.W
WWHB...YRW
WWWWWWWWWW
