043-10-08-024
WWWWWWWWWW
WPWWWWP.WW
WB.WWWA.WW
WW.WWWW.WW
WW.WWWW.WW
WH..WWWHWW
WA.GB..GWW
WWWWWWWWWW
