044-10-08-024
WWWWWWWWWW
WWWWWWWWWW
WWWWWWW.BW
WWWWWWH.WW
WWWW.BW.WW
WWG..W.Y.W
W.YRHG.R.W
WWWWWWWWWW
