045-10-08-024
WWWWWWWWWW
WWWWWWWWWW
WWP.WWWWWW
WAW.WWWWWW
WRH.WWWWWW
WEW......W
WRHEA..WPW
WWWWWWWWWW
