046-10-08-023
WWWWWWWWWW
WWY.WWWWWW
WWW.WWWWWW
W.G.WWWWWW
W.W.E.WWWW
W..HW...WW
W..GRHREYW
WWWWWWWWWW
