047-10-08-023
WWWWWWWWWW
WWW.PWW.EW
WWW.WWW.WW
WWW..WW.WW
WWWG.WW.WW
WW.B...PWW
WGYE...YBW
WWWWWWWWWW
