048-10-08-023
WWWWWWWWWW
WWWB.WWWWW
WB.W.WWWWW
WP...WWWWW
WG.A..WWWW
WWAWW.W.PW
W.GA..G.WW
WWWWWWWWWW
