049-10-08-023
WWWWWWWWWW
WW.BWWWWWW
WW.WWWW.EW
WW.WW...RW
WW.WW.W.WW
WG.H.H..WW
WR.B.W.GEW
WWWWWWWWWW
