045-11-11-095
G.G........
YBPR....B..
WWWWWWTWWC.
..G........
.CWWTWWWWWW
..R....BY..
WWWWWWTWWC.
...Y..Y....
.CWWTWWWWWW
YRP........
WWWWWWWWWWW
