050-10-08-023
WWWWWWWWWW
WB.WWWWWWW
WW.WWWWWWW
WW.WWWWWWW
WW.WW.EWAW
WA....W.YW
WWRE.YB.RW
WWWWWWWWWW
