054-10-08-023
WWWWWWWWWW
WWWWE..BWW
WWWWW..WWW
WWWWW..WWW
WWWWW..PWW
W.Y....GBW
WGW.E..YPW
WWWWWWWWWW
