056-10-08-022
WWWWWWWWWW
WWWWWWWWWW
WWWWWWWWWW
WWWWWW.GWW
WW..GW.WWW
WWHEB..WWW
WPEPW.HB.W
WWWWWWWWWW
