057-10-08-022
WWWWWWWWWW
WWWWWW.YWW
WWWWWW.WWW
WWWWWW.WWW
WWR.WW.WWW
WEY.WW.PWW
WHP...REHW
WWWWWWWWWW
