058-10-08-022
WWWWWWWWWW
WWWWWWWWWW
WRWAWWWWWW
WA.B.WWWWW
WW.W.WWWWW
WP.W...YWW
WY...PWBRW
WWWWWWWWWW
