046-07-10-097
W.G..GW
W.WY.WW
W.BW.YW
W.WR.WW
W.RW.GW
W.WPM0401WW
W.RW.PW
W.W..WW
WM0101B.BYW
WWWWWWW
