047-11-11-095
WGR.B.....W
WWWWW.....W
WB.GP.....W
WWWWWW....W
WYG..G....W
WWWWWWW...W
WYR.P.....W
WWWWWWWW..W
W.........W
WYBYRYGP.M1001W
WWWWWWWWWWW
