048-11-11-075
WWWWWWWWWW.
WRYGP....WW
WWWWWC...BW
....W...CWW
...WWG...W.
.WWW.P..Y.W.
.WBY.G.M0701P.W
.WWWTWTWWFW
...W....WWW
...WRB.BW..
...WWWWWW..
