005-08-08-075
WBP...PW
WYG...WW
.WBY..GW
..WP..WW
...W...W
...W...W
..WGYM0501.W
..WWWWWW
