001-10-08-012
WWWWWWWWWW
WWWWWWW.AW
WWWWWWW.WW
WWWWWEB.WW
WWWW.PW.WW
WW...W..WW
WE.B.YAYPW
WWWWWWWWWW
