002-10-08-013
WWWWWWWWWW
WWWWY..WBW
WW.BWAY.GW
WW.WWGB.WW
WW.W.BW.WW
WW.W.WW.WW
WW......AW
WWWWWWWWWW
