004-10-08-013
WWWWWWWWWW
WWWWWWW.EW
WE.WWW..WW
WWG.WW.GWW
WWW..YHWWW
WWW..HYWWW
WWW..EWWWW
WWWWWWWWWW
