005-10-08-013
WWWWWWWWWW
WWWWWWWWWW
WWWWWWWWWW
WWWWWY..GW
WWWWBW..WW
WWW.AYP.WW
WWPAWBW.GW
WWWWWWWWWW
