006-10-08-009
WWWWWWWWWW
WWWWB.WWWW
WWWWW.WWWW
WWWWW.WWWW
WPWEW.WWWW
WBEA..WWWW
WWBPW.A.WW
WWWWWWWWWW
