008-10-08-011
WWWWWWWWWW
WWWWWWW.GW
WW.BWWW.WW
WW.WWWG.WW
WW.WWWW.WW
WWY..RW.WW
WRB.EY.EWW
WWWWWWWWWW
