009-10-08-016
WWWWWWWWWW
WWWWWWWWWW
WWWWWWWWWW
WEWWWP.WWW
WY.WWWE.WW
WW..B.PGWW
WB.GYWWWWW
WWWWWWWWWW
