010-10-08-018
WWWWWWWWWW
WWWWWWWWWW
WWWWWW.GWW
WWWWWW.WWW
WWWWWW.WHW
WRY.....GW
WWWHAR.YAW
WWWWWWWWWW
