011-10-08-008
WWWWWWWWWW
WW.PWWWWWW
WW.WWWWBAW
W..WWWWWGW
W.WWWWW.BW
W.WWWW..WW
W.PWWW.GAW
WWWWWWWWWW
