012-10-08-010
WWWWWWWWWW
WWBWWWWWWW
W.RWWWWWWW
W.Y.WWW.EW
W.B.WWW.WW
W.W..W.YWW
WRWA...EAW
WWWWWWWWWW
