013-10-08-013
WWWWWWWWWW
WWWWWWWWWW
W.RWWWWWWW
W.WWWWWWWW
W..GWWWWWW
W.EB...WWW
WGRWG.EGBW
WWWWWWWWWW
