014-10-08-014
WWWWWWWWWW
WWW.HBWWWW
W...PAWWWW
W.W.HE..WW
W.W.AWW.WW
W.WWBWW.WW
W..PWWE.WW
WWWWWWWWWW
