015-10-08-017
WWWWWWWWWW
WWWWH.WWWW
WWWWW.WWWW
W.PWW.WWWW
WYWWW.WWWW
WB......WW
WP.R.YBHRW
WWWWWWWWWW
