016-10-08-019
WWWWWWWWWW
W.HWWWW.HW
W.YWWWW.WW
W.WWWWW.WW
WE...WW.EW
WW.W.W.GRW
WW...YGRWW
WWWWWWWWWW
