017-10-08-022
WWWWWWWWWW
WWWWWWWWWW
WWWWWWWWWW
WWWWWWWWWW
WBWWW.HWWW
WH.W..R.PW
WE..P.BERW
WWWWWWWWWW
