018-10-08-023
WWWWWWWWWW
WWW..PWWWW
WE..WWP.WW
WW..WWW.WW
WWWY.WW.WW
W.HWH.W.WW
WRERY...WW
WWWWWWWWWW
