019-10-08-011
WWWWWWWWWW
WWW.YWWWWW
WWW.W.PWGW
WWW.W.H.HW
WWW.WPW.WW
WWW.WWW.WW
WWW..G.Y.W
WWWWWWWWWW
