020-10-08-013
WWWWWWWWWW
WWWWWWW.YW
WWE.WWH.WW
WWW..YW.RW
WWW..WW.WW
WWW...E.WW
WWW.R.W.HW
WWWWWWWWWW
