021-10-08-014
WWWWWWWWWW
WWWWWWWWWW
WWWWWWWWWW
WWWWWW..GW
WWW....PWW
WY..YA.WWW
WWY.PG.AWW
WWWWWWWWWW
