022-10-08-010
WWWWWWWWWW
WWWWWWWY.W
WWWWWW.E.W
WWW.GW.W.W
WWW.WWBW.W
WWGE..Y..W
WWBP.PW..W
WWWWWWWWWW
