023-10-08-012
WWWWWWWWWW
WWWWWWWWWW
WWWWWEW.AW
WW.B.GW.WW
W..W.WY.WW
W.WW..BYWW
W.EWAGWWWW
WWWWWWWWWW
