024-10-08-015
WWWWWWWWWW
WWWWWWWWWW
WWWWWW.AWW
W.EWWW.WWW
W.WWWW..AW
WG.H..P.WW
WE.P.GW.HW
WWWWWWWWWW
