025-10-08-015
WWWWWWWWWW
WWWWWWWWWW
WWWWW.PWWW
WWWWW.WWWW
WW.AW.WWWW
WR.P.Y..WW
WPYA.PWRWW
WWWWWWWWWW
