026-10-08-017
WWWWWWWWWW
WWWWE...AW
WWWWW..WWW
WWWW...WWW
WWWW.W.WWW
W.GPEW.WWW
W.PBGBAWWW
WWWWWWWWWW
