027-10-08-018
WWWWWWWWWW
WWWE.WWWWW
WWWW.WWWWW
WWWW.W.BWW
WW.P...GWW
WP.H...WWW
WHGW...EBW
WWWWWWWWWW
