028-10-08-018
WWWWWWWWWW
WWR.WWWWWW
WWW.WWWWWW
WWR.WWWWWW
WWWE..WWWW
WWWHG...RW
WWWWEH..GW
WWWWWWWWWW
