029-10-08-012
WWWWWWWWWW
WA.WWWWWWW
WW.WWWWWHW
WW.WWWWWPW
WW..AWW.BW
WWR.R...WW
WWW.PBW.HW
WWWWWWWWWW
