030-10-08-012
WWWWWWWWWW
WWWWWWWWWW
WW..YWWWWW
WW.WWRWWWW
WW..WB.RWW
WWE..E.PWW
WWY.PW.BWW
WWWWWWWWWW
