031-10-08-013
WWWWWWWWWW
WWWWWWWWWW
WWWY.BWWWW
WWWW.WWH.W
WWWW.WWW.W
WP...W..EW
WBW.YE.PHW
WWWWWWWWWW
