032-10-08-015
WWWWWWWWWW
WH.W.YWWWW
WW.W.WGWWW
WW.W..EWWW
WE.Y.BWWWW
WW.W.H.WWW
WWWW.GBWWW
WWWWWWWWWW
