033-10-08-016
WWWWWWWWWW
WWWWWWAWWW
WWWWW.PWWW
WWWWW.WWWW
WWWWW...WW
WW...P.GBW
WGB.WWYAYW
WWWWWWWWWW
