034-10-08-018
WWWWWWWWWW
WWWWWWWWWW
WWWWWWWWWW
WH...WWWWW
WWWG..WWWW
WWYR...HAW
W.RY.AWWGW
WWWWWWWWWW
