035-10-08-020
WWWWWWWWWW
WWWWWWW.AW
WY.WWW..WW
WW.G.W.WWW
WW.R.P.YWW
WW.W.W.GWW
WW.W..PARW
WWWWWWWWWW
