036-10-08-021
WWWWWWWWWW
WWWWWWWWWW
WW.AWB..RW
WW.WWW..WW
WW.WWW..EW
WB......HW
WRWAE.H.WW
WWWWWWWWWW
