037-10-08-014
WWWWWWWWWW
WB..AWWWWW
WW..WWWWWW
WW.H.WWWWW
WW.B.EWWWW
WW.WEWWWWW
WWW.A.H.EW
WWWWWWWWWW
