038-10-08-013
WWWWWWWWWW
WW.HWWWWWW
WW.WWW.YWW
WW.WWW.BWW
WW.A.A.HWW
WW.W.B.WWW
WW.W.Y.BWW
WWWWWWWWWW
