039-10-08-013
WWWWWWWWWW
WG.WWWWWHW
WW.WWWW.PW
WW.WWW..WW
WW.WWR..WW
WW.W.YHGWW
WW..YWPRWW
WWWWWWWWWW
