040-10-08-016
WWWWWWWWWW
WWWWP.WWWW
WWWWW.W.EW
WWWB..W.RW
WWWW....WW
W.GW...PWW
WGR..EWBWW
WWWWWWWWWW
