041-10-08-019
WWWWWWWWWW
WER.WWWWWW
WWW.WWWWWW
WWW.WWWWWW
WWW...RBWW
WW....BHWW
WYH.Y.WEWW
WWWWWWWWWW
