042-10-08-027
WWWWWWWWWW
WWWWWWWWWW
WWWWWWWYWW
WWWWWW.BWW
WBH....HWW
WWW..YPWWW
WP..WWHBWW
WWWWWWWWWW
