043-10-08-014
WWWWWWWWWW
WWWWWWW.AW
WWW.PWW.WW
WWA.WW.EWW
WWP.WW.WWW
WWW..B.GWW
WWWGWE.BWW
WWWWWWWWWW
