044-10-08-016
WWWWWWWWWW
WWRY.WWWWW
WWWA.WWRWW
WWWW.W.PWW
WWWW.W.WWW
WWWW.AE.WW
WP...WYEWW
WWWWWWWWWW
