045-10-08-017
WWWWWWWWWW
WWWWWWWWWW
WW.GWWWWWW
WW.R.WWWWW
WW.W.WWPWW
WP.G..GHWW
WH.W..RGWW
WWWWWWWWWW
