046-10-08-019
WWWWWWWWWW
WWWWWWWWWW
WWGWWWWWWW
WWR.WWWWWW
WWW.WWWBWW
W..R...HWW
WHWBY.YGWW
WWWWWWWWWW
