047-10-08-022
WWWWWWWWWW
WWWWWW.HWW
WWWWWW.WWW
WWWWWW.WWW
WR.WWW.WWW
WB......PW
WPEHB.EWRW
WWWWWWWWWW
