048-10-08-017
WWWWWWWWWW
WWWWWWW.PW
WWRWWWW.WW
WWPWWWW.WW
WWY...W.WW
WWW.B.R.WW
WB..YPW.WW
WWWWWWWWWW
