049-10-08-016
WWWWWWWWWW
WWWWR.WWWW
WWB.W.WWWW
WWW.W.WWWW
WHW.R.W.HW
WG..B.W.WW
WE.EWG..WW
WWWWWWWWWW
