050-10-08-019
WWWWWWWWWW
WWWWWWW.EW
WWWWWWW.HW
WWWWWWW.YW
WWWWWW..BW
WWW.G..YWW
WBEGW..HWW
WWWWWWWWWW
