051-10-08-023
WWWWWWWWWW
WR.WWWWWWW
WW.WWWWWWW
WW.WWWW.RW
WW.WA.E.WW
WY..Y.A.BW
WB.EW.W.WW
WWWWWWWWWW
