052-10-08-026
WWWWWWWWWW
WWWWWWWWWW
WWWWWWWWWW
WW.AWWWWWW
WR.WWWE.GW
WA....H.RW
WG....WEHW
WWWWWWWWWW
