053-10-08-016
WWWWWWWWWW
WWG.WWWWWW
WWW.G.YWWW
WWWWW.EWWW
W.....WWWW
W.WR..B.WW
W.YW.REBWW
WWWWWWWWWW
