054-10-08-019
WWWWWWWWWW
WWWRWWWWWW
WW.AW.HWWW
WW.WW.WWWW
WW.WW.WWWW
WW..B..RWW
W..BWHEAEW
WWWWWWWWWW
