056-10-08-026
WWWWWWWWWW
WWWW.YWWWW
WW.ARWWWWW
WW.WWWWWWW
W...B.WWWW
W...W..BPW
WRP..A.WYW
WWWWWWWWWW
