057-10-08-020
WWWWWWWWWW
WWWWWWW.EW
WWWWWWW.HW
WW.PWWW.WW
WW.WW..HWW
WW.B..REWW
WB.WR.PWWW
WWWWWWWWWW
