058-10-08-030
WWWWWWWWWW
WWWWW.YWWW
WWWG..WWWW
W.PWA.WWWW
W.WPW.WWWW
W.AE...YWW
WEGW...WWW
WWWWWWWWWW
