060-10-08-025
WWWWWWWWWW
WWWWWWWWWW
WWWWWWWWWW
WR.A..WWWW
WW.WW.H.WW
WWP..HY..W
WWY.PWR.AW
