010-09-09-85
W.RG.GR.W
W.WWTWW.W
P.BY.YB.B
W.WWTWW.W
W.PG.GP.W
W.WWTWW.W
W.......W
W.W.W.W.W
WWWWWWWWW
