006-09-10-85
WWWW...YW
W..W...BW
W.G.Y..WW
W.WYP..GW
W.WWW.M0101PW
W.W....WW
W.WTWCC.W
WB...CC.W
WM0101G.B.P.W
WWWWWWWWW
