001-10-08-012
WWWWWWWWWW
WWWWWWWWWW
WWWWG.GWWW
WWWBE.WWWW
WWWWW.W.EW
WWWWH...WW
WWWWWRBRHW
WWWWWWWWWW
