003-10-08-031
WWWWWWWWWW
WWWWWWW.EW
WWWWWW..HW
WWWW...WWW
WWW.G.WWWW
WWW.WWB.HW
W.R.BEGRWW
WWWWWWWWWW
