004-10-08-016
WWWWWWWWWW
WWWH..WWWW
WWWWGY.WWW
WWW.HW.WWW
WWW.WE.WWW
WE..WW.WWW
WG..Y.H.WW
WWWWWWWWWW
