005-10-08-021
WWWWWWWWWW
WWWWWWWWWW
WWWWWW.AWW
WWWWWW.GEW
WWWWWW.WWW
WH...G..YW
WAWW.WYHEW
WWWWWWWWWW
