006-10-08-014
WWWWWWWWWW
WWW..HWWWW
WWW.RGWWWW
WW..WWWWWW
WW.RWW.HWW
W..Y.W.WWW
WYRGH...WW
WWWWWWWWWW
