007-10-08-025
WWWWWWWWWW
W.HWWWWWWW
W.WW.PH.WW
WE.W.WW.EW
WW.W.W..WW
WW.W....PW
WWE.RP.RWW
WWWWWWWWWW
