008-10-08-015
WWWWWWWWWW
WWWWW.GWWW
WWWWW.WWWW
WWWWA.WWWW
WWWWW.WWWW
WWWG...ERW
WB.R..BAEW
WWWWWWWWWW
