009-10-08-016
WWWWWWWWWW
WY.WR..WWW
WW.WHP.WWW
WW.EWW.WWW
WW.WWW.WWW
WW....HWWW
WW.P.YREWW
WWWWWWWWWW
