010-10-08-021
WWWWWWWWWW
WWWWWA.WWW
WP.WWW...W
WWH.WWWW.W
WWW.WWW..W
WWW...AY.W
WWWYH.BPBW
WWWWWWWWWW
