011-10-08-014
WWWWWWWWWW
WWWWWW..YW
WWWWWW.WWW
WPWWWW.WWW
WA.WW.YWWW
WW.E..EWWW
WWAW..PWWW
WWWWWWWWWW
