012-10-08-013
WWWWWWWWWW
WWWWE.WWWW
WWWWW.WWWW
WWWWWRWWWW
WWWWWGWWWW
WP.W.Y.Y.W
WW..RGPWEW
WWWWWWWWWW
