013-10-08-013
WWWWWWWWWW
WWWWWWWWWW
WWWWWWWWWW
WWWWWGWWWW
WW.R.BWWWW
WH.W.G..WW
WWGH.WRGBW
WWWWWWWWWW
