014-10-08-018
WWWWWWWWWW
WWWWWWPH.W
WWWWWWWP.W
WWWWWW.H.W
WWWWWW.W.W
WWWWWAB..W
WB.G.GWAWW
WWWWWWWWWW
