015-10-08-018
WWWWWWWWWW
WWWWPE.WWW
WWWWWY..WW
WR.WWWA.WW
WW.WWWW.WW
WW.WWW...W
WW..EAPRYW
WWWWWWWWWW
