016-10-08-022
WWWWWWWWWW
WGWWWWWWWW
WH.WWWWWWW
WWBWWWWWWW
W.R.WWWWWW
WHW.WWWGWW
WBY....RYW
WWWWWWWWWW
