018-10-08-010
WWWWWWWWWW
WA.WWWWWWW
WY..WWWWWW
WWP.WWWWWW
WWW.WWWWWW
WWWP.R.AWW
WWWY.W.RWW
WWWWWWWWWW
