019-10-08-012
WWWWWWWWWW
WWWW.RWWWW
WWWW.WWWWW
WWWW.WE.WW
WWWWA.W.WW
WWW.E..HWW
WWWHWA.RWW
WWWWWWWWWW
