020-10-08-015
WWWWWWWWWW
WWWWWWWWWW
WWWWWWWWWW
WW..BY.WWW
WWEWWW.WWW
WWB...P.WW
WWWY..WPEW
WWWWWWWWWW
