021-10-08-016
WWWWWWWWWW
WWWWWWWWWW
WWHWWWWWWW
WWG.WW..YW
WAW..W.WWW
WH...G.WWW
WW.AYHY.WW
WWWWWWWWWW
