022-10-08-011
WWWWWWWWWW
WAWWWWWWWW
WY.WWWWWWW
WB.WWWWWWW
WW.WRWWWWW
WB..G..WWW
WR.YWAGWWW
WWWWWWWWWW
