023-10-08-012
WWWWWWWWWW
WWWWWPWWWW
WR.WWB.AWW
WW.WWW.R.W
WW.WWW.W.W
WW.WW..WPW
WG.G.A.BWW
WWWWWWWWWW
