024-10-08-015
WWWWWWWWWW
WWWWWWWWWW
WWW.YWWWWW
WWW.WWWPWW
WWW.WWWY.W
WWW..G.GAW
WB..ABWPWW
WWWWWWWWWW
