025-10-08-016
WWWWWWWWWW
WA..WWWWWW
WWW.WWWWWW
WWW.WWWWWW
WWW..RW.GW
WW..AY..BW
WRG.WB.YWW
WWWWWWWWWW
