026-10-08-018
WWWWWWWWWW
WWWWWWWWWW
WWWG.WWWWW
WWWW.W.EWW
WEWW.Y.WWW
WA...WG.WW
WY.HAHW.WW
WWWWWWWWWW
