027-10-08-019
WWWWWWWWWW
WW.HW.BEWW
WW.WW.WWWW
WW.WW.WWWW
WW.W.E..AW
W.G..A.WWW
WHW..WG.BW
WWWWWWWWWW
