028-10-08-027
WWWWWWWWWW
WWWWWWWWWW
WWWWWWWWWW
WWWWW.AWWW
WWWWE.WWWW
WY.GA.G..W
WW.WWWE.YW
WWWWWWWWWW
