029-10-08-012
WWWWWWWWWW
WWWWWWWWWW
WWWWE.AWWW
WWW.ABP.WW
WWY.BWW.WW
WWW.WWW.WW
WW.EYWWPWW
WWWWWWWWWW
