030-10-08-013
WWWWWWWWWW
WA.WWW.EWW
WW.WW..WWW
WW.W..YWWW
W.A..GWWWW
W.WE.H.WWW
W.GW.YHWWW
WWWWWWWWWW
