031-10-08-014
WWWWWWWWWW
WWWWWWWWWW
WWWWWWWWWW
WWWWWW.YWW
WWWWW..EWW
WWGY.R.WWW
WARAGW.EWW
WWWWWWWWWW
