032-10-08-016
WWWWWWWWWW
WWWW.HWWWW
WWH..WWWWW
WWW..G..BW
WWW..W..WW
WWWB..A.PW
WWPAW.G.WW
WWWWWWWWWW
