033-10-08-017
WWWWWWWWWW
WWWH..YWWW
WWWW..RWWW
WWWW..WWWW
WWWW..WWWW
WWB....B.W
WAYAW.RWHW
WWWWWWWWWW
