034-10-08-018
WWWWWWWWWW
WWWWWWWWWW
WWWW.HWWWW
WWWW.WWWWW
WWW.GW.GWW
WWW.YPEWWW
WW.EPWH.YW
WWWWWWWWWW
