035-10-08-021
WWWWWWWWWW
WG.WWWWWWW
WW.R.WWWWW
WWWW.WWWWW
WWWA.WWWWW
WWWR....EW
WWGBEB.WAW
WWWWWWWWWW
