036-10-08-007
WWWWWWWWWW
WWWWWWWWHW
WWWWWWWWYW
WWWWWWA.AW
WWWWWWW.WW
WWW.RWWY.W
WWR.WW.AHW
WWWWWWWWWW
