037-10-08-016
WWWWWWWWWW
WB.W.EWWWW
WW.W.WWWWW
WW...WWWWW
WWW.....GW
WW.YBW..EW
WWYWGB..WW
WWWWWWWWWW
