038-10-08-012
WWWWWWWWWW
WWWW.RWWWW
WWWW.WW.AW
WWWW.WW.YW
WWWW.E.YWW
WWE..G.WWW
WWARGW.WWW
WWWWWWWWWW
