039-10-08-016
WWWWWWWWWW
WWWWWWW.HW
WWWWWWW.WW
WWWWEWW.WW
WWW.GWW.WW
WW..RP..PW
WHRWEW..GW
WWWWWWWWWW
