040-10-08-017
WWWWWWWWWW
WH.WWWWWWW
WW.WWWWWWW
WW.WWWW.GW
WW.P.EW.WW
WW.AGH..PW
WW.WEA..WW
WWWWWWWWWW
