041-10-08-022
WWWWWWWWWW
WWWWWWWWWW
WWWWW..EWW
WWWWW.WA.W
WWWW..WW.W
WWB..AEH.W
WWHY.BYW.W
WWWWWWWWWW
