042-10-08-013
WWWWWWWWWW
WWWWWW.PWW
WWWWWW.YWW
WWWWWW.WWW
WW.....WWW
WW.EG.WWWW
WWYWEG.PWW
WWWWWWWWWW
