043-10-08-016
WWWWWWWWWW
WW.EWWWWWW
WW.PWWWWWW
WW.EWWWWWW
WWPWWWWWWW
W.Y...R.WW
WRA.AWW.YW
WWWWWWWWWW
