044-10-08-016
WWWWWWWWWW
WWWWWRP.WW
WWWWWWB.WW
WWGWWWW.WW
W.AWWW..WW
W.P.....WW
WARGW.W.BW
WWWWWWWWWW
