045-10-08-019
WWWWWWWWWW
WWWB.WWWWW
WWWW.WWWWW
WWEW.WWWWW
W.A..W.AWW
WHGE...GWW
WWWB..WHWW
WWWWWWWWWW
