046-10-08-022
WWWWWWWWWW
WH..WWWRWW
WWW.WW.YWW
WWW.WW.EHW
WWW.W..WWW
WWW.....GW
WG..EYW.RW
WWWWWWWWWW
