047-10-08-014
WWWWWWWWWW
WWWWWWWWWW
WWWWWWWWWW
WWWWWWWWWW
WWWBWWWRWW
WW.E...EPW
WR.WPEBWWW
WWWWWWWWWW
