049-10-08-019
WWWWWWWWWW
WWWWWWWWWW
WBWWWWWWWW
WY.WPW.HWW
WW..R..BWW
WW.WYR.WWW
W..PHW.WWW
WWWWWWWWWW
