052-10-08-016
WWWWWWWWWW
WWW.Y.AWWW
WWA.W.WWWW
WWW.W...EW
WWWR..YWWW
WWWW..AEWW
WWW...WRWW
WWWWWWWWWW
