053-10-08-018
WWWWWWWWWW
WWWWW.PWWW
WWWWW.A.WW
WWWWW.W.WW
WWWWW.W.YW
WW..H...GW
WGHYWA.PWW
WWWWWWWWWW
