054-10-08-020
WWWWWWWWWW
WWWWWAWWWW
WWWW.RW.HW
WP...WW.WW
WW...G..WW
W...AW..WW
WR..GWHPWW
WWWWWWWWWW
