058-10-08-020
WWWWWWWWWW
WE.W.PWWWW
WB.W.WWWWW
WW....HWWW
WW....PWWW
WWR...H.WW
WWE...WBRW
WWWWWWWWWW
