059-10-08-019
WWWWWWWWWW
WWWWWWW.GW
WW.PWWW.WW
WW.WWWW.WW
WE.WWW..WW
WA.G...YWW
WW.PWYAEWW
WWWWWWWWWW
