060-10-08-023
WWWWWWWWWW
WWWWWWWWWW
WWWWWW..HW
WY.WWW.EWW
WW.E...GAW
WW.Y...WGW
WWWW.HAWWW
