007-09-09-80
...WWW...
..WY.PW..
.W.PCB.W.
WY.G.P.YW
WG..C..BW
WB.....GW
.W..C..W.
..WM0302.M0502W..
...WWW...
