001-10-08-022
WWWWWWWWWW
WWWWWWWP.W
W.AWWWWW.W
W.WWWWWP.W
W.WWWBWW.W
W....AER.W
W..E.RWB.W
WWWWWWWWWW
