002-10-08-023
WWWWWWWWWW
WWWWWWWWWW
WG.WWWW.BW
WB.WWWW.WW
WH.WW.Y.WW
WWR...R.WW
WHY.HWWGWW
WWWWWWWWWW
