003-10-08-030
WWWWWWWWWW
WWWWWWWWWW
WB.WWWWWWW
WW.WWWWWWW
WE..WWPWWW
WWBR..G..W
WGPAEAWRWW
WWWWWWWWWW
