004-10-08-020
WWWWWWWWWW
WWW.GWWBWW
WWW.WW.AWW
WWW.WW.HWW
WW.....WWW
WB.W.G..WW
WA.B.W.HWW
WWWWWWWWWW
