005-10-08-025
WWWWWWWWWW
WWWYWWWWWW
WW.PWW.GWW
WW.WW..WWW
WE...H.WWW
WBWWPWEWWW
WYH.GBWWWW
WWWWWWWWWW
