006-10-08-020
WWWWWWWWWW
WWWWA.WR.W
WWWWW.WW.W
WWWWW.WW.W
WR.W.H.P.W
WW...A.H.W
WWYP.Y.W.W
WWWWWWWWWW
