007-10-08-028
WWWWWWWWWW
WWWWWWWWWW
WWWWR..WWW
WWRWY.A.WW
WWAWWWW.WW
WWH..B..WW
WWW.AWBYHW
WWWWWWWWWW
