008-10-08-027
WWWWWWWWWW
WWR.WWWWWW
WWW.WWWWWW
WWW.WWP.WW
WWW.WRWA.W
W....BEG.W
WWB.AWGEPW
WWWWWWWWWW
