009-10-08-038
WWWWWWWWWW
WWWWY.A..W
W.RWW.WG.W
W.WWW.WW.W
W.WWW...GW
W......PRW
W..YAW.WPW
WWWWWWWWWW
