010-10-08-022
WWWWWWWWWW
WWWWWWWWWW
WWWWWRWWWW
WWE..A.WWW
WWW..W.WWW
WWA..W..YW
WBY.BE..RW
WWWWWWWWWW
