011-10-08-029
WWWWWWWWWW
WWG.WWWWWW
WWW..WWWWW
WWWW..AWWW
WGWW..WEAW
WBY....PRW
WPEW.B.RYW
WWWWWWWWWW
