012-10-08-021
WWWWWWWWWW
WWWG.WWWWW
WWPW.WW.HW
WWRW.WW.WW
WWG..WW.WW
WWW.HA..WW
WA..WRP.WW
WWWWWWWWWW
