013-10-08-025
WWWWWWWWWW
W.RWWWWWWW
W.WWW.RBEW
W.WWW.GWWW
W.WWW.W.BW
WY.W.Y..HW
WH...GW.EW
WWWWWWWWWW
