014-10-08-032
WWWWWWWWWW
WWWWWWWWGW
WWWWWWW.AW
WWWWW.R.WW
W..Y..W.WW
W.WE.....W
WGWARBEYBW
WWWWWWWWWW
