015-10-08-024
WWWWWWWWWW
WWWWWWW.BW
WW.BWWW.WW
WW.YWWW.WW
W..W.YWAWW
W.R..W.GWW
W.AG.YRWWW
WWWWWWWWWW
