016-10-08-023
WWWWWWWWWW
WAWWW.BRWW
WB.WW.RWWW
WW..W.WWWW
WW..W.WWWW
WY......HW
WWH..WWAYW
WWWWWWWWWW
