017-10-08-022
WWWWWWWWWW
WW.AHWWWWW
WW.WWWWWWW
W..WWWWWWW
WE.WWWW.GW
WY.H.YWGWW
WHWW.A.EWW
WWWWWWWWWW
