018-10-08-029
WWWWWWWWWW
WWE.WWWWWW
WWA..YWWWW
WWWW.WWWWW
WWA..WWWWW
WWHY....EW
WWWEW...HW
WWWWWWWWWW
