019-10-08-026
WWWWWWWWWW
WH.W.PWWWW
WW.W.HWWWW
WW.W.WWWEW
WW......BW
W..P....YW
WEYW.HB.WW
WWWWWWWWWW
