020-10-08-036
WWWWWWWWWW
WWWWB.WWWW
WWWWA..HWW
WG.WW..WWW
WW.....WWW
WW..WAH..W
WWWBYRGRYW
WWWWWWWWWW
