021-10-08-028
WWWWWWWWWW
WB.WWWWG.W
WE.WWWWW.W
WW..WW.G.W
WW..P..WWW
WWH.R.R.WW
WWP.WBEHWW
WWWWWWWWWW
