022-10-08-040
WWWWWWWWWW
WWWWW.PWWW
WWWWW.WWWW
WWWWW.WWWW
WBG.W...HW
WAP.....PW
WHWA.G..BW
WWWWWWWWWW
