023-10-08-024
WWWWWWWWWW
WPA.WWW.HW
WBGE.WW.WW
WWWW.WW.WW
WWB..WW.WW
WWWW.....W
WP.EH.AWGW
WWWWWWWWWW
