024-10-08-022
WWWWWWWWWW
WWWWWWWWWW
WW.GWWWWWW
W..PWWWWWW
WE.E..WWWW
WPWW.G..RW
WWWH.ER.HW
WWWWWWWWWW
