025-10-08-021
WWWWWWWWWW
WWWWWW.PWW
WWWWWW.WWW
WH.WWW..WW
WW.WW.R.GW
WB....B.PW
WRW..GH.WW
WWWWWWWWWW
