026-10-08-024
WWWWWWWWWW
WWWW.EWRWW
WWWW.W.GWW
WWWW..HWWW
WY.W..W.GW
WW......WW
WWR.H.WEYW
WWWWWWWWWW
