027-10-08-021
WWWWWWWWWW
WWWWWW.BWW
WWWE...WWW
WWWWW.WWWW
WWWW..PWWW
WHAH..WWWW
WPEW..ABWW
WWWWWWWWWW
