028-10-08-028
WWWWWWWWWW
WWWWWWY.WW
WWWWWWW.HW
WWWRWW..AW
WWWE....WW
W.EH...PYW
WAPW...WRW
WWWWWWWWWW
