029-10-08-028
WWWWWWWWWW
WWWWWWWWBW
WR.WWWW.RW
WW.WW...WW
WWEWW.W.PW
WWP.....GW
WWHBGHW.EW
WWWWWWWWWW
