030-10-08-022
WWWWWWWWWW
WWWW.HW.PW
WWWW.WG.WW
WE.W.WW.WW
WW...WW.WW
WHW.PBE..W
WG..WWW.BW
WWWWWWWWWW
