031-10-08-026
WWWWWWWWWW
WWWWWW.HWW
WWWWWW.WWW
WWP..W.WWW
WWYA..BWWW
WWHW..WABW
WWWP..GYGW
WWWWWWWWWW
