032-10-08-024
WWWWWWWWWW
WB.WWWWWWW
WW.WP.WWWW
WW.WW.WWWW
WW.GE..WWW
W.GYW.BEWW
WWYW.RPRWW
WWWWWWWWWW
