033-10-08-020
WWWWWWWWWW
WWH.WWWWWW
WWW..BGWWW
WW.G.WWWWW
WW.W..WWWW
WW.R.B.WWW
W..BWR.HWW
WWWWWWWWWW
