034-10-08-022
WWWWWWWWWW
WWWWWWWWWW
WE.WWWWWWW
WB.WWWWWWW
WW.WWWWWWW
WR.....YHW
WHBW..YERW
WWWWWWWWWW
