035-10-08-021
WWWWWWWWWW
WWWWWWWWWW
WH.WWWWWWW
WW.WWWWWWW
WG...WWWWW
WW.RA..B.W
WB.AR.HWGW
WWWWWWWWWW
