036-10-08-024
WWWWWWWWWW
WR.WWWWWWW
WW.WWWW.GW
WW.WWW.GWW
WW.P...HWW
WYEYP..RWW
WHWEW..WWW
WWWWWWWWWW
