037-10-08-024
WWWWWWWWWW
W..RWWWWWW
W.WWWWW.YW
W.WWWWW.WW
W.WWWWW.WW
W....A..EW
WA.PER.YPW
WWWWWWWWWW
