038-10-08-030
WWWWWWWWWW
WWWWWWWWWW
WWWWWWWWWW
WWWW.E.PYW
WWWW.Y.WWW
WWR..BEAWW
WPA..WWBRW
WWWWWWWWWW
