039-10-08-024
WWWWWWWWWW
WWWW.PR.WW
WWWW.WW.WW
WWWW.WG.WW
WW...WY.WW
WW.BGYR.HW
WWPHWBW.WW
WWWWWWWWWW
