040-10-08-026
WWWWWWWWWW
WWWW.RWWWW
WWWW.WWWWW
WWWW.WWWEW
WWY..WW.GW
WWA.....WW
WGY..EWARW
WWWWWWWWWW
