041-10-08-020
WWWWWWWWWW
WWY.WWW.PW
WWWE.WW.EW
WWWW.WW.WW
WWWWR.W.WW
WP..E..YWW
WEW.WR.WWW
WWWWWWWWWW
