042-10-08-025
WWWWWWWWWW
WWWWWWWWWW
WWWWWWW.EW
WH.WWWW.WW
WW.WWWWAWW
WW.E...HGW
WG.WRH.RAW
WWWWWWWWWW
