043-10-08-025
WWWWWWWWWW
WWWWWWWWWW
WWW.AP.WWW
WWW.YW.WWW
WWW.WH..WW
WW..PE..GW
WEGAWW.HYW
WWWWWWWWWW
