044-10-08-025
WWWWWWWWWW
WWY..WWWWW
WWWW.WWWWW
WWHR...WWW
W.EWWW..WW
W.W.GB..EW
W.RGWH.YBW
WWWWWWWWWW
