045-10-08-025
WWWWWWWWWW
WWWWHWWWWW
WWWAY.WWWW
WWWWW.WWWW
WWE.W.WWWW
WWA..G..RW
WWHYRW.GEW
WWWWWWWWWW
