046-10-08-024
WWWWWWWWWW
WWWWWWWWWW
WWWWWWWWWW
WWWWYP.WWW
WWWWWG..WW
WW...HR.WW
WWYRGWPH.W
WWWWWWWWWW
