047-10-08-024
WWWWWWWWWW
WWWWWWWWWW
WWWWWWWWWW
WWGB..EWWW
WWRW..WWWW
W.B...AWWW
WAWEGYR.YW
WWWWWWWWWW
