048-10-08-027
WWWWWWWWWW
WWWWE.WWWW
WWWWW.WWWW
WWWW.H..HW
WP...W..WW
WW...A.BAW
WGBG.EWHPW
WWWWWWWWWW
