049-10-08-024
WWWWWWWWWW
WWW.GHRWWW
WW.PWWWWWW
WW.WWWWWWW
WW...AWRWW
WWA..W.YWW
WYHG.P.WWW
WWWWWWWWWW
