050-10-08-023
WWWWWWWWWW
WWWE.WWWWW
WWWW.WWWWW
WWWW.WWWWW
WWWW...WWW
WWWP.G..RW
WYGYRP.WEW
WWWWWWWWWW
