051-10-08-031
WWWWWWWWWW
WWWWWWR..W
WWWWWWWE.W
WWWWW.PG.W
WWE...WW.W
WWGB.H.W.W
WHPW.B.WRW
WWWWWWWWWW
