052-10-08-026
WWWWWWWWWW
WWWW..HWWW
WWWW.WY.WW
WWWW.WW.WW
WWWW.W.YWW
WA..R.BR.W
WHBWG.AG.W
WWWWWWWWWW
