053-10-08-025
WWWWWWWWWW
WW.PWWWWWW
W..HWHBWWW
W.WWWWE.WW
W.....P.WW
W.B..WW.WW
W.W.PWE.WW
WWWWWWWWWW
