054-10-08-024
WWWWWWWWWW
WWWWWWWWWW
WWWWB.WWWW
WWWWA.WWWW
WH.GB.WWWW
WW.RY..WWW
WGAYW..HRW
WWWWWWWWWW
