055-10-08-024
WWWWWWWWWW
W.GWWWWWWW
W.H.P.WWWW
W.W.W.WWWW
W.W.W.WRWW
W.H.E.EY.W
WRYGW.WWPW
WWWWWWWWWW
