056-10-08-020
WWWWWWWWWW
WWWWWWWWWW
WHWWWWW.AW
WEWWWWW.EW
WH...A..WW
WWW..P.WWW
WWA..WPWWW
WWWWWWWWWW
