057-10-08-021
WWWWWWWWWW
WA.WWWWWWW
WY.WWWWWWW
WW.WWEWWWW
WW.W.AW.BW
WR.B.W..RW
WWEW...YWW
WWWWWWWWWW
