058-10-08-033
WWWWWWWWWW
WWWWWWWWWW
WWWWWWWWWW
WWWWWWWWWW
WWWW..E.EW
W.RG..A.WW
WGYAY.W.RW
WWWWWWWWWW
