059-10-08-024
WWWWWWWWWW
WWWWW.AWWW
WWWB..WWWW
WWWW..WWWW
WWWW..HGWW
W..B..EA.W
WWAG..HWEW
WWWWWWWWWW
