060-10-08-028
WWWWWWWWWW
WWWWBWWWWW
WWPHG.WWWW
WWWWW.WWWW
WWR...WWWW
WPEH..WWEW
WBWGA..ARW
