008-08-07-70
R.YPGR.Y
W.WWWW.W
W......W
WCCCCCCW
WCCCCCCW
WPYPGRGW
WWWWWWWW
