001-10-08-042
WWWWWWWWWW
WWWWWWW.EW
WWWWWWW.WW
WWWWWWW.WW
W.YP....RW
WEBYGB..WW
WRWPWW.G.W
WWWWWWWWWW
