002-10-08-030
WWWWWWWWWW
WWWWWWWWWW
WWWWWWWWWW
WWWWWWWWWW
WH..G...PW
WYR.Y...GW
WPWWWR..HW
WWWWWWWWWW
