003-10-08-036
WWWWWWWWWW
WWWWWWWWWW
WWWWWWWWWW
WWE..WWWWW
WABW..WWWW
WHPH.Y.A.W
WWWBYW.PEW
WWWWWWWWWW
