004-10-08-039
WWWWWWWWWW
WWWWWWWWWW
WRWWWWWWWW
WE.WWWWWWW
WW.....EHW
WG..BP.WRW
WW.PGWHBWW
WWWWWWWWWW
