005-10-08-031
WWWWWWWWWW
WRP.WWWWWW
WWW.W.PWWW
WWW.W.WWWW
WW..W.WWWW
WA.EY...AW
WY.WWR..EW
WWWWWWWWWW
