006-10-08-033
WWWWWWWWWW
WWWWWWWWWW
WWWWWE.WWW
WWWWWW.WWW
WWWHWW.WWW
WA.GARH.WW
WR.WWEG.WW
WWWWWWWWWW
