007-10-08-033
WWWWWWWWWW
WWWWWWW.YW
WWWWWWW.WW
WWWWWWWEWW
WWWWW..BWW
WWW..PEA.W
W.Y.ABWWPW
WWWWWWWWWW
