008-10-08-030
WWWWWWWWWW
WWWWWWWWWW
WWWWWWP.WW
WWWWWWW.WW
WWW.....GW
WP.E.A..YW
WGWWAWYEWW
WWWWWWWWWW
