009-10-08-040
WWWWWWWWWW
WWWWH.WWWW
WWWWW.WWWW
W.BWW.WWWW
W.WW....AW
W.P.HEPRWW
WEA.WRWBWW
WWWWWWWWWW
