010-10-08-043
WWWWWWWWWW
WWWWWWWWWW
WWWWWWWWWW
WR..WWWWWW
WBE....WWW
WRH.G.E.YW
WHWYW.GBWW
WWWWWWWWWW
