011-10-08-033
WWWWWWWWWW
WWWWWWWWWW
WE..WWWWWW
WWW.WWWWWW
WWY.....GW
WWWW..Y.YW
WBAG.ABWEW
WWWWWWWWWW
