012-10-08-037
WWWWWWWWWW
WWWWWWWWWW
WWWWWW..BW
WWWWW.PWWW
WWW...BWWW
WWR..EGAWW
W.P.GAWERW
WWWWWWWWWW
