013-10-08-030
WWWWWWWWWW
WWWWWWWG.W
WWWWWWWW.W
WWWWWWWW.W
WR..YWWW.W
WP.HR....W
WWHYW.P.GW
WWWWWWWWWW
