014-10-08-033
WWWWWWWWWW
WWR.WWWWWW
WWW.WWWWWW
WWW.P.G.WW
WWW.WWW.WW
WRA.....WW
WAW.EGPERW
WWWWWWWWWW
