015-10-08-041
WWWWWWWWWW
WWWWWWWWWW
WWWWWWWWWW
WWWWWWW.AW
WP....W.PW
WG.HAHE.RW
WE.WGWR.WW
WWWWWWWWWW
