016-10-08-027
WWWWWWWWWW
WWWP.WWWWW
WWWWH..WWW
WWWWWW.PWW
WWWWR..E.W
WWE.W..W.W
W.HP...WRW
WWWWWWWWWW
