017-10-08-030
WWWWWWWWWW
WWB.WWWWWW
WWW.WWWWWW
WWW.WWWWWW
WWW..EW.BW
W...AWW.WW
WPE.PG.AGW
WWWWWWWWWW
