018-10-08-031
WWWWWWWWWW
WWWWWWWWWW
WWWWWWWWWW
WWP.WWWWWW
WWB..B.WWW
WPR..Y..RW
WYW.WWA.AW
WWWWWWWWWW
