019-10-08-030
WWWWWWWWWW
WWWWWW.HWW
WWWWWW.WWW
WWWWWW..PW
WWWWW.Y.WW
WRB...W.WW
WYWRB.H.PW
WWWWWWWWWW
