020-10-08-035
WWWWWWWWWW
WWWWWWWWWW
WWWWWWWWWW
WWWWWWWWWW
WWA..WWWWW
WHRY..A..W
WYWW.BHBRW
WWWWWWWWWW
