021-10-08-037
WWWWWWWWWW
WWB.WWWWWW
WWW.HWWWWW
WWW.WWWWWW
W.......BW
WEA..GA.WW
WGB.HWW.EW
WWWWWWWWWW
