022-10-08-039
WWWWWWWWWW
WWWWWWWWWW
WW.YWWWWWW
WE.WWWWWWW
WW..W.H.AW
W.....PYEW
W.H.AEWPWW
WWWWWWWWWW
