023-10-08-033
WWWWWWWWWW
WW.Y.GWWWW
WW.WWWWWWW
WW..WWWWWW
WAE..WWWWW
WWW.H...EW
WWAYE.GWHW
WWWWWWWWWW
