024-10-08-043
WWWWWWWWWW
WWWWWWWWWW
WWWWWWWWWW
WWWWWWWWWW
WRA....WWW
WGPG....YW
WWAWYEPERW
WWWWWWWWWW
