025-10-08-030
WWWWWWWWWW
WWWWWWWWWW
WWWWWWWWWW
WGWWWWWWWW
WY.....RWW
WWE.Y..A.W
WWGWWARWEW
WWWWWWWWWW
