026-10-08-038
WWWWWWWWWW
WWWWWWWWPW
WWWWWWW.YW
WWWWWWW.WW
WE.....PYW
WW..HR.HEW
WW..EW.WRW
WWWWWWWWWW
