027-10-08-027
WWWWWWWWWW
WWWR.W.EWW
WR.G.W.WWW
WW.W.W.WWW
WW.W...WWW
WW.P.E..WW
WW.WWRGPWW
WWWWWWWWWW
