028-10-08-043
WWWWWWWWWW
WWWWWWW.BW
WWE..HW.WW
WWW..WW.WW
WB.H....WW
WW.AEY...W
WH.WYW.A.W
WWWWWWWWWW
