029-10-08-030
WWWWWWWWWW
WWWWWWWWWW
WWWWW.EWWW
WH.WW.WWWW
WW...EWWWW
WA.A.B..GW
WWGW.WH.BW
WWWWWWWWWW
