030-10-08-052
WWWWWWWWWW
WWWA.WWWWW
WWWW.WWWWW
WWWW.W..BW
WH....WEAW
WB.REYRGHW
WY.WWWGWWW
WWWWWWWWWW
