031-10-08-047
WWWWWWWWWW
WWWWWWWWWW
WWWWWWWWWW
WWWWWWW.BW
WWWHE...WW
WGAYB...AW
WPEPGHWYWW
WWWWWWWWWW
