032-10-08-036
WWWWWWWWWW
WWWWWWWWWW
WWWWWWWWWW
WWWWWWAWWW
WB....H.WW
WPYE..BWWW
WEHWP.AYWW
WWWWWWWWWW
