033-10-08-034
WWWWWWWWWW
WA.BWWWWWW
WR.WWWWWWW
WW.WWWWWWW
WH..WWWWWW
WWA.....GW
W.HGB.W.RW
WWWWWWWWWW
