034-10-08-037
WWWWWWWWWW
WWWWWWWWWW
WWWE.WWWWW
WWWW.WWWWW
WWWW...BWW
WH.EG.PE.W
WW.GP.BWHW
WWWWWWWWWW
