035-10-08-024
WWWWWWWWWW
WWWWWWWWWW
WH.WWWWWWW
WW.WWWWWWW
WY..WWWWWW
WW...B.EBW
WHE..WWWYW
WWWWWWWWWW
