036-10-08-033
WWWWWWWWWW
WWWWWWWWWW
WE.WWW.BWW
WW..WW.AWW
WW..G..WWW
WW.EP.WWAW
WWWWG.BEPW
WWWWWWWWWW
