037-10-08-025
WWWWWWWWWW
WWWWWWWWWW
WP.WA..GHW
WH.WW.WWAW
WW..W.WWWW
WWW...WWWW
WPG....WWW
WWWWWWWWWW
