038-10-08-031
WWWWWWWWWW
WWWWWWWWWW
WWWWWWWWWW
WWWWWW.EWW
WWWWWW.GRW
WWYR...AGW
WWEWY..WAW
WWWWWWWWWW
