039-10-08-050
WWWWWWWWWW
WWWWWWWWWW
WWWWWWWWWW
WWWWWYWWWW
WWW..R..HW
WB.R.G.AGW
WW.YHWBWAW
WWWWWWWWWW
