040-10-08-032
WWWWWWWWWW
WWWWWWWWWW
WWWWWWWWWW
WWWWY.W.BW
WWW.P..BPW
WW..RH.WWW
WH..WW.RYW
WWWWWWWWWW
