041-10-08-027
WWWWWWWWWW
W.HW..G.HW
W.WW.WW.WW
W.WW.WW.WW
W.P..WW.WW
W.W...E.PW
WG..H.WEWW
WWWWWWWWWW
