042-10-08-037
WWWWWWWWWW
WWWWWWWWWW
WWWWWWW.RW
WWWWW...WW
WWW..BE.AW
WH...PB.WW
WARWPWEH.W
WWWWWWWWWW
