043-10-08-038
WWWWWWWWWW
WWWWWWWWWW
WWWWWWWWWW
WWWWWWWWWW
WWW.YPWY.W
W...GBPRAW
WR..WWABGW
WWWWWWWWWW
