044-10-08-036
WWWWWWWWWW
WWWWW.BWWW
WWWWW.WWWW
WWWP..WWWW
WWWW....WW
W....YBRAW
WG.YAGWPRW
WWWWWWWWWW
