045-10-08-034
WWWWWWWWWW
WWE.RWW.AW
WWW.WWW.WW
WWW.WWW.WW
WE...WW.WW
WHR..G.YHW
WAWWYW.WGW
WWWWWWWWWW
