046-10-08-034
WWWWWWWWWW
WWWWWWWWWW
WWWWWW..EW
WWWWWB.GYW
WWWWWWWWAW
WGP...B.YW
WEA...WPWW
WWWWWWWWWW
