047-10-08-034
WWWWWWWWWW
WWWWWWWWWW
WWWWWWW.PW
WWWWWWW.RW
WH.WWWB.WW
WW..H.E.AW
WBE.APW.RW
WWWWWWWWWW
