048-10-08-034
WWWWWWWWWW
WH.WWWWWWW
WR.WWWWWWW
WW...WWWWW
WWW.E...BW
WH..GWRWEW
WY..B.YGWW
WWWWWWWWWW
