049-10-08-029
WWWWWWWWWW
WWWWWW.BWW
WP..BW.WWW
WW..WW..AW
WA...G..WW
WW.W.W..WW
W....W.PGW
WWWWWWWWWW
