050-10-08-037
WWWWWWWWWW
WWWWWWWWWW
WWWWWG.RWW
WE.WWW.WWW
WA..WW..WW
WR.EYP...W
WP.WAWGY.W
WWWWWWWWWW
