051-10-08-039
WWWWWWWWWW
WGB.WWWWWW
WWW.WWWWWW
WWW..WWWWW
WWW.....WW
W.GHR..APW
WAPRWB.HWW
WWWWWWWWWW
