052-10-08-038
WWWWWWWWWW
WR.WWWWWWW
WG.WWWWWWW
WW.WWWWWWW
WW.WWEAWWW
W....APYGW
W.YPWWRWEW
WWWWWWWWWW
