053-10-08-032
WWWWWWWWWW
WWWWWWWG.W
WWW.HWWW.W
WWH.WWWW.W
WWW..WWW.W
WBYEG....W
WYEWB....W
WWWWWWWWWW
