054-10-08-036
WWWWWWWWWW
WWWWWWW.YW
WWWWWWW.GW
WWWWWW..WW
WWWWWW..GW
WAHY...GWW
WHWE..EA.W
WWWWWWWWWW
