055-10-08-036
WWWWWWWWWW
WWWWWHWWWW
WW.G.R.WWW
WW.PWW.WWW
WW.WW..WWW
WW.B.H...W
W..RWWGPBW
WWWWWWWWWW
