056-10-08-040
WWWWWWWWWW
WG.WWW.YWW
WW.WWW.WWW
WW.WWW.WWW
WB..W...AW
WW.Y.E..RW
WEGARW.BWW
WWWWWWWWWW
