057-10-08-041
WWWWWWWWWW
WWH.WWWWWW
WWWG.WWWWW
WWWW.WWWWW
WWB...WAWW
W.Y....HRW
WRW.WYGBAW
WWWWWWWWWW
