058-10-08-036
WWWWWWWWWW
WG.WWWW.YW
WW.WWWW.BW
WW.WWW..WW
WWP..W.WWW
WWWR.P.EWW
WB.EYWGR.W
WWWWWWWWWW
