059-10-08-046
WWWWWWWWWW
WWWW.BWWWW
WWWW.WWWWW
WY...WWWWW
WA.W...AEW
WP..ERGRWW
WWWWYWPGBW
WWWWWWWWWW
