060-10-08-052
WWWWWWWWWW
WWWWWWWWWW
WWWWWWWWWW
WWWW.EWWWW
W....GWWWW
WRBY.PG..W
WBHPRHWYEW
