013-11-10-40
WY.......RW
WG.......YW
WB.......PW
WY.......BW
WP.......GW
WR.......YW
WG.......PW
WR.......BW
WPBYPGRPBYW
WWWWWWWWWWW
