009-10-09-75
WP......PW
.WP....YW.
..WR.RGW..
..WY.WBW..
..WB..PW..
..WGW.YW..
..WB..PW..
.WRG..YGW.
WWWWWWWWWW
