001-10-08-042
WWWWWWWWWW
W.AWR.AWWW
W.WWP.PWWW
WEWEA.WWWW
WPGYE.RWWW
WAEWHPWRYW
WBGBPERHPW
WWWWWWWWWW
