002-10-08-042
WWWWWWWWWW
WWWWYWWWWW
WW..GWWWWW
WY.PB.HEWW
WP.YWRGYWW
WW.AEWRP.W
WRHRBAPYRW
WWWWWWWWWW
