003-10-08-043
WWWWWWWWWW
WEA..GRAGW
WGE..HBPAW
WWY..BWBPW
WEH.GWYEWW
WWP.B.EARW
WRGAWGRWPW
WWWWWWWWWW
