004-10-08-043
WWWWWWWWWW
WWWGWW.EHW
WA.BW.YWWW
WPEGWAERWW
WGPBRYAWWW
WYWYARWE.W
WGEPBEGHGW
WWWWWWWWWW
