005-10-08-039
WWWWWWWWWW
WWWRWWW.YW
WWWP.AW.WW
WG.GRY..WW
WAHBAH..EW
WEGYEBYPWW
WWAEWRHYRW
WWWWWWWWWW
