006-10-08-043
WWWWWWWWWW
WARWAWWWWW
WWAWGWWWWW
WWHEH.W.RW
WEWYAHEGPW
WP.WBGAPEW
WBPHGHPYWW
WWWWWWWWWW
