007-10-08-043
WWWWWWWWWW
WWWRWWE.WW
WWWGYWW.WW
W.HPE.WE.W
W.PWWRGY.W
WARWYPWPEW
WPE.PAYEHW
WWWWWWWWWW
