008-10-08-043
WWWWWWWWWW
WWWWWWHWWW
WWWWE.BR.W
WG.GH.AHEW
WYHPBERARW
WHABEPWYAW
WEPRBYPWYW
WWWWWWWWWW
