009-10-08-043
WWWWWWWWWW
WPBY.WWBWW
WEGW.YWEWW
WYAR.R.H.W
WRWYHA.W.W
WEYWBHGH.W
WPRBPAEYPW
WWWWWWWWWW
