010-10-08-043
WWWWWWWWWW
WWB..ABWWW
WHW..REWWW
WGRY.GH.WW
WEPW.WW.WW
WBYAHRY.RW
WHEHWEHEPW
WWWWWWWWWW
