011-10-08-043
WWWWWWWWWW
WYP.WWWHGW
WWG.WWWGEW
WWERWB.ABW
WWWAGP.GEW
WHAGAYEHRW
WRBPHRGEWW
WWWWWWWWWW
