012-10-08-043
WWWWWWWWWW
WWPWPWY.WW
W.GPE.WBWW
WEWYH.HP.W
WRWWW.AY.W
WHYAHGWAPW
WWGBARPYWW
WWWWWWWWWW
