013-10-08-043
WWWWWWWWWW
WP.PWWWWYW
WA.W.BEGBW
WRE..PHPRW
WWBA.YGYHW
WGARGRPWRW
WWWYAYRWWW
WWWWWWWWWW
