014-10-08-043
WWWWWWWWWW
WWWWA.WWWW
WWWGE.WYWW
W.GHB..EAW
WPYGP.GREW
WGWWW.BGWW
WHPBHRHEPW
WWWWWWWWWW
