015-10-08-044
WWWWWWWWWW
WY.A.WWWHW
WB.P.P..RW
WPRH.E.GBW
WRAR.W.EYW
WWYPB.PAGW
WYHAHEAHEW
WWWWWWWWWW
