016-10-08-044
WWWWWWWWWW
WEYWWWWPWW
WPE.W.PREW
WWWE.EGHBW
WWWYRABYWW
WG.EAPWWAW
WWBAWGHBYW
WWWWWWWWWW
