017-10-08-044
WWWWWWWWWW
WPWWWWWWWW
WGR.WWA.EW
WPA..GPAYW
WWGH.YARBW
WBWYBHYWHW
WEHAEAPGAW
WWWWWWWWWW
