018-10-08-044
WWWWWWWWWW
W.GP.EAWRW
W.AE.WG.BW
W.WR.WP.WW
WYGEHWH.BW
WGYAPEGEPW
WBGWGHEBAW
WWWWWWWWWW
