019-10-08-044
WWWWWWWWWW
WY.WWWWEWW
WRY..B.YPW
WWW..HYWYW
WWEBHWGYGW
WRHPREBWRW
WWGYAHEYAW
WWWWWWWWWW
