020-10-08-044
WWWWWWWWWW
WWWWW.GYWW
WWW..GYWWW
WWW.HABWAW
WWW.GWWWBW
WEY.PBEHPW
WBA.BEPEYW
WWWWWWWWWW
