021-10-08-044
WWWWWWWWWW
WWWWB.W.YW
WWWWWPWEGW
WPH..B.YRW
WWWG.REHBW
WAYB.PRGWW
WGBE.AHYRW
WWWWWWWWWW
