022-10-08-044
WWWWWWWWWW
WWBWWY.YWW
W.ABWR.G.W
WAWE.A.RAW
WHRWEG.HGW
WPY.HB.PBW
WAEBAYPBRW
WWWWWWWWWW
