023-10-08-044
WWWWWWWWWW
WWWWWWGAHW
WYWE.HEWWW
WP.H.RWWWW
WRPB.GWYBW
WHRG.EPEAW
WWWHAWEHPW
WWWWWWWWWW
