024-10-08-044
WWWWWWWWWW
WY.WWWW.GW
WW.WWWWGWW
WABHYG.AWW
WREREP.GWW
WHRPYEGYAW
WEWRBGPRGW
WWWWWWWWWW
