025-10-08-044
WWWWWWWWWW
WWYWW.AWWW
W.EYW.WWWW
WRYE.GPBWW
WYGAHRWAGW
WHPEYEBEPW
WWWYHPAGYW
WWWWWWWWWW
