026-10-08-044
WWWWWWWWWW
WRWARHE.WW
WE.BHGWAYW
WGYWWW.PWW
WBWAWW.EBW
WH.ERY.BEW
WEPRPHPAYW
WWWWWWWWWW
