027-10-08-044
WWWWWWWWWW
WWWWWWWWWW
WWWWYWW.EW
WWWWAP..WW
W..AGB..WW
WY.BEWEPRW
WWREYHAGHW
WWWWWWWWWW
