028-10-08-044
WWWWWWWWWW
WPHYAPWWWW
WWWARHB.BW
WWWRGWP.WW
W.EYWGE.GW
WHPREAW.AW
WGEHPHAEHW
WWWWWWWWWW
