029-10-08-045
WWWWWWWWWW
WEYWW.BWHW
WWA.BAG.YW
WAP.HEB.WW
WPHBGPW.WW
WYRHWB..WW
WGHRAEGHYW
WWWWWWWWWW
