030-10-08-045
WWWWWWWWWW
WWG.G.W.RW
WYW.R.W.WW
WR.EW..RWW
WWBPEG.AWW
WARHRPRGRW
WRYEBGYHYW
WWWWWWWWWW
