031-10-08-045
WWWWWWWWWW
WA.E.WBREW
WG.W..EAHW
WW.WPERWWW
WRBAEYWYWW
WPARWAHABW
WEREGBYHWW
WWWWWWWWWW
