032-10-08-045
WWWWWWWWWW
WY.WPA.AEW
WAH.WH.WWW
WWBGHG..YW
WBGYRWY.WW
WEABAHPGRW
WAWYHRGHWW
WWWWWWWWWW
