033-10-08-045
WWWWWWWWWW
WY.E.HWR.W
WARP.WGERW
WEGH..HBEW
WWPWY.EPBW
WWEBH.AERW
W.GRAYRWWW
WWWWWWWWWW
