034-10-08-045
WWWWWWWWWW
WWWWW.RWPW
WWWW..BRGW
WREP.AWGWW
WYPHEGPRHW
WBRBGBRBYW
WPWABGHWPW
WWWWWWWWWW
