035-10-08-045
WWWWWWWWWW
WWWY.GWE.W
WWWW.WWW.W
WR.H...WEW
WAEAYB.BGW
WBPWBR.RHW
WGHGHYPWWW
WWWWWWWWWW
