036-10-08-045
WWWWWWWWWW
WWEWWWWWWW
WPH.AWWWBW
WWE.EYAHPW
WHA.WWGYRW
WWP.GPEAHW
WBHEWGHRYW
WWWWWWWWWW
