037-10-08-045
WWWWWWWWWW
WBWW.EH.PW
WAE..WR.GW
WWW...A.BW
WAWG.GW.EW
WBEAEBPRAW
WWHYGEAYRW
WWWWWWWWWW
