038-10-08-046
WWWWWWWWWW
WWA.HE.ARW
WWW.RG.WWW
WWR.WB.WWW
WEA.YW.WAW
WWPRGEYAPW
WGRBAHEGWW
WWWWWWWWWW
