039-10-08-046
WWWWWWWWWW
WWWWWWWWWW
WWWWYRWWWW
W.E.BHG.RW
WEAGYWAYGW
WRPWHGBHRW
WGYGYPHYAW
WWWWWWWWWW
