040-10-08-046
WWWWWWWWWW
W.PYWWWYWW
W.YGER.REW
W.WBPG.WYW
WAPRWW.EGW
WYEYGBEPWW
WRGRPRAWWW
WWWWWWWWWW
