041-10-08-046
WWWWWWWWWW
WHWWEB.PEW
WB.RAE.WWW
WA.BGR.HYW
WW.ABW.BGW
WPGPEAYWRW
WWRBHBGPGW
WWWWWWWWWW
