042-10-08-046
WWWWWWWWWW
WAPGWWWYWW
WBGWP.WRWW
WWHBR..GWW
WWWEHYPYPW
WRBRWPGPEW
WYPGAHBHGW
WWWWWWWWWW
