043-10-08-046
WWWWWWWWWW
WHY.WP.WWW
WWW..E..YW
WR..AWE.GW
WGBYBRPARW
WHPRHWGRPW
WGRBYERHWW
WWWWWWWWWW
