044-10-08-047
WWWWWWWWWW
WRHBWR.Y.W
WGWWAH.A.W
WPWWYB.W.W
WG.EBWWH.W
WPAGEA.EPW
WERAYHBPYW
WWWWWWWWWW
