045-10-08-047
WWWWWWWWWW
WWPWW.BWWW
WBY.G.W.HW
WYWRY..EPW
WA.BW.RYGW
WPGHGBWBYW
WEABPAYAPW
WWWWWWWWWW
