046-10-08-047
WWWWWWWWWW
WWWWWWWWWW
WAB.WWWWWW
WWR.WWWWWW
WWW.E.WWEW
W.HRB.Y.GW
WYPGAHAPRW
WWWWWWWWWW
