047-10-08-047
WWWWWWWWWW
WWYH.YWWWW
WWPA.WWWWW
W.ERGWG.RW
WRWPRYW.AW
WABGABYPYW
WEAHGPEREW
WWWWWWWWWW
