048-10-08-048
WWWWWWWWWW
WBHRWW.BPW
WGYE.H.HWW
WWWW.PEGYW
WHPW.YBRPW
WEGH.RAGEW
WWPBABGPWW
WWWWWWWWWW
