049-10-08-048
WWWWWWWWWW
WWWWWWWWWW
WWWWWWWWWW
WE.WWWWWWW
WPB.....WW
WYG..B.HYW
WGWHWP.EWW
WWWWWWWWWW
