050-10-08-049
WWWWWWWWWW
WWWWW.GRAW
WWWWW.AWWW
WWWWW.GWWW
WRG.E.EPHW
WBRABRHRBW
WWHYGPEYHW
WWWWWWWWWW
