051-10-08-049
WWWWWWWWWW
WWWWWW.EBW
WWWWA..RWW
WPWRY..BAW
WGPEWA.WEW
WHGPAGHPAW
WPBEPWPBYW
WWWWWWWWWW
