052-10-08-050
WWWWWWWWWW
WE.W.YWWWW
WGE.EGWWWW
WYWPYWWA.W
WEWAEGRYBW
WBYBWEBERW
WEAGPRGRYW
WWWWWWWWWW
