053-10-08-050
WWWWWWWWWW
WWB.WH.WWW
W.PEWW.YWW
WPHARA.WWW
WWARGPBE.W
WHWAHYEWBW
WYAERGAPYW
WWWWWWWWWW
