054-10-08-052
WWWWWWWWWW
W.GWG.EPAW
W.YWH.WWWW
W.BWR.HBWW
W.YEAGWAYW
WYBAEHARWW
WRAHWPRYPW
WWWWWWWWWW
