055-10-08-052
WWWWWWWWWW
WWPHP.GPWW
W.RBY.AWGW
WYAGW.R.EW
WAHER.WAHW
WWWWW.HBYW
WWAYEBAGPW
WWWWWWWWWW
