056-10-08-052
WWWWWWWWWW
WW.AR.EWWW
WW.BGRB.WW
W.EPEBWE.W
W.HGYEWAEW
WPYABRYGYW
WYBHWWABGW
WWWWWWWWWW
