057-10-08-053
WWWWWWWWWW
W.HWWWRP.W
WPAW.PWW.W
WBE.PGWPBW
WPRGERYAPW
WRWPBWAYAW
WBPYEHYPWW
WWWWWWWWWW
