058-10-08-056
WWWWWWWWWW
WWW.YGWGHW
W.G.PBRWRW
W.YEAWWRHW
WARBWRPYWW
WYWPGHGHYW
WHRYHPEGWW
WWWWWWWWWW
