059-10-08-058
WWWWWWWWWW
WWWWBA.HWW
W.PARWYG.W
WPGRWBHB.W
WGBHYGPWHW
WPRYWWWEGW
WHGHGEPYWW
WWWWWWWWWW
