060-10-08-084
WWWWWWWWWW
WEWWAWWPWW
WA.RY.RGWW
WE.WWPYARW
WGBAPHEWWW
WYREGRGWBW
WGWPHGYRAW
WWWWWWWWWW
